time,open,high,low,close,Volume,Volume MA,Volume,Volume MA,RSI,OnBalanceVolume,Accumulation/Distribution,Accumulation/Distribution,OnBalanceVolume,ADX,Aroon Up,Aroon Down,Histogram,MACD,Signal,RSI,%K,%D
1434844800,246.08,246.98,242,244.66,3632,6051.8,3632,6051.8,61.3527728394418,23049,101406.49879266536,101406.49879266536,23049,26.38705324857849,71.42857142857143,0,1.8346242404936923,3.8222294394902008,1.9876051989965084,61.3527728394418,58.69383198437067,62.11974096945766
1434931200,244.66,248.5,243.86,247.5,5543,5882.05,5543,5882.05,64.55230754899804,28592,104560.27465473431,104560.27465473431,28592,26.865542009593064,64.28571428571429,0,1.626906227193237,4.021237982988055,2.3943317557948176,64.55230754899804,62.00762388818302,61.420259302150676
1435017600,247.48,248.06,243.01,244.52,5264,5803.85,5264,5803.85,59.029961780456475,23328,102444.2508923581,102444.2508923581,23328,27.077560904166898,57.142857142857146,7.142857142857143,1.1994221841020751,3.8936094859224113,2.694187301820336,59.029961780456475,52.541296060991186,57.7475839778483
1435104000,244.54,244.92,239.51,240.04,5281,5771.75,5281,5771.75,51.84876723757527,18047,98197.97547646162,98197.97547646162,18047,26.367777344287425,50,0,0.5581422495341024,3.391865113737964,2.8337228642038617,51.84876723757527,36.86605981794541,50.47165992237321
1435190400,240.14,243.44,239.91,242.44,5637,5724.6,5637,5724.6,55.00661214555391,23684,100641.2077710792,100641.2077710792,23684,25.708692610113626,42.857142857142854,0,0.2542695539163238,3.1515598065992663,2.8972902526829425,55.00661214555391,44.50603195304861,44.63779594399508
1435276800,242.46,243.1,239.91,243,6509,5871.75,6509,5871.75,55.7360611107144,30193,106742.11999678455,106742.11999678455,30193,25.096685356952243,35.714285714285715,7.142857142857143,0.059802654666879285,2.972043571016542,2.9122409163496625,55.7360611107144,46.33192044343011,42.56800407147472
1435363200,242.99,252.22,242.6,251.59,5242,5955.4,5242,5955.4,65.08645634273405,35435,111297.53787620245,111297.53787620245,35435,25.956976822339346,28.571428571428573,0,0.45642300334760444,3.482769670534168,3.0263466671865635,65.08645634273405,70.77608614927597,53.871346181918234
1435449600,251.46,251.87,247.51,249.11,4231,5820.4,4231,5820.4,61.075134197717034,31204,110171.85897711992,110171.85897711992,31204,26.755818897341655,21.428571428571427,0,0.49523207489508714,3.6453867608054225,3.1501546859103353,61.075134197717034,59.97679814385161,59.028268245519236
1435536000,249.11,257.99,249.09,257.54,10380,6023.25,10380,6023.25,68.24040282487758,41584,119502.1960557716,119502.1960557716,41584,28.207662866486128,14.285714285714286,0,1.0028595124092377,4.403729076421882,3.4008695640126447,68.24040282487758,91.81236673774004,74.18841701028921
1435622400,257.53,269.39,255.91,263.82,11992,6325.95,11992,6325.95,72.32713543202757,53576,121583.89338514848,121583.89338514848,53576,30.466147688458516,100,0,1.638228853206789,5.448655630521131,3.810426777314342,72.32713543202757,81.35876840696119,77.71597776285095
1435708800,263.83,265.45,255.12,259.02,8226,6459.05,8226,6459.05,65.40012137550164,45350,119569.20025833335,119569.20025833335,45350,32.36174574284137,92.85714285714286,50,1.6095236634319967,5.822331356604337,4.212807693172341,65.40012137550164,65.29451137884871,79.48854884118332
1435795200,258.96,262,253,254.85,6260,6470.95,6260,6470.95,60.021952627458276,39090,115882.7558138889,115882.7558138889,39090,33.57748928851996,85.71428571428571,42.857142857142854,1.2026308948400892,5.716096311722453,4.513465416882363,60.021952627458276,51.33868808567606,65.99732262382867
1435881600,254.86,257.37,252.77,256.95,4759,6504.2,4759,6504.2,61.728804459963385,43849,119772.7210312802,119772.7210312802,43849,34.64621175231541,78.57142857142857,35.714285714285715,0.9774231829047881,5.735244395513348,4.75782121260856,61.728804459963385,58.366800535475235,58.333333333333336
1435968000,256.94,261,254.4,260.64,4034,6592.6,4034,6592.6,64.58966102101206,47883,123366.64830400748,123366.64830400748,47883,35.9601473971232,71.42857142857143,28.571428571428573,0.9771402453789637,5.979246519332264,5.0021062739533,64.58966102101206,70.71619812583667,60.14056224899599
1436054400,260.64,275.25,258.99,271.74,8420,6713.05,8420,6713.05,71.49297014126729,56303,128151.44535197796,128151.44535197796,56303,38.08579556036325,100,21.428571428571427,1.5885124196031724,6.987746798457266,5.399234378854094,71.49297014126729,90.17907106883047,73.08735657671413
1436140800,272.17,277.88,268.27,269.94,9984,6692.25,9984,6692.25,69.13908601363514,46319,121637.43078381983,121637.43078381983,46319,40.18431534443606,100,14.285714285714286,1.7243406241510195,7.554660159042868,5.830319534891848,69.13908601363514,79.30675006515509,80.06733975327408
1436227200,269.78,272.11,264.5,266.18,6944,6546.35,6944,6546.35,64.3713277168394,39375,117759.37559328107,117759.37559328107,39375,41.261064408498676,92.85714285714286,7.142857142857143,1.4259740002321744,7.612787035182066,6.186813034949892,64.3713277168394,69.50742767787338,79.66441627061964
1436313600,266.18,273.97,264.41,270.97,7763,6524.95,7763,6524.95,67.4507155791573,47138,120650.1998610635,120650.1998610635,47138,42.380052572264646,85.71428571428571,0,1.4134942834850115,7.953680889306156,6.540186605821145,67.4507155791573,81.80142217540173,76.87186663947672
1436400000,271.5,272.5,267.1,269.75,6942,6568.6,6942,6568.6,65.88870234146836,40196,120521.64430550791,120521.64430550791,40196,43.41911301004732,78.57142857142857,0,1.194091350040222,8.032800793371422,6.8387094433312,65.88870234146836,78.58835923097183,76.63240302808232
1436486400,269.77,294.71,269,286.67,15862,7145.25,15862,7145.25,74.65499164097994,56058,126462.95352371098,126462.95352371098,56058,45.43158000375116,100,0,2.0114252633813496,9.352991022557887,7.341565759176538,74.65499164097994,84.5710995970064,81.65362700112665
1436572800,286.71,299,284.5,294.23,8476,7387.45,8476,7387.45,77.44420545804456,64534,129362.33007543514,129362.33007543514,64534,47.434510264768235,100,0,2.8338019746618635,10.883818227503866,8.050016252842003,77.44420545804456,90.73606525538943,84.63184136112255
1436659200,294.29,316.52,293.5,312.16,12895,7755.05,12895,7755.05,82.39316444354432,77429,137372.6906314734,137372.6906314734,77429,49.72137795307038,100,0,4.271559433746912,13.389465545025644,9.117906111278732,82.39316444354432,93.53403529586244,89.61373338275276
1436745600,312.19,312.91,281.62,293.08,12942,8138.95,12942,8138.95,65.83855987245994,64487,133910.73665256638,133910.73665256638,64487,50.03361511392917,92.85714285714286,0,3.6480285159738717,13.67794175624607,10.029913240272199,65.83855987245994,63.231372549019596,82.50049103342383
1436832000,292.93,297.78,286.25,287.51,7115,8230.65,7115,8230.65,61.92683737570354,57372,128350.79302724113,128350.79302724113,57372,50.3235496204409,85.71428571428571,21.428571428571427,2.619070541692242,13.303751417387502,10.68468087569526,61.92683737570354,54.49411764705882,70.41984183064696
1436918400,287.48,294.11,284.98,285.7,7556,8326.6,7556,8326.6,60.66548209060896,49816,121986.53891990264,121986.53891990264,49816,50.403262346734245,78.57142857142857,14.285714285714286,1.623923444509014,12.714585181331529,11.090661736822515,60.66548209060896,51.6549019607843,56.46013071895425
1437004800,285.7,292.78,275,279.38,8576,8429.95,8576,8429.95,56.34957246245802,41240,117635.83475792289,117635.83475792289,41240,49.10156010003925,71.42857142857143,7.142857142857143,0.41061669146881385,11.603932601158533,11.19331590968972,56.34957246245802,41.74117647058823,49.296732026143786
1437091200,279.38,281.38,272.64,280.58,6967,8516.2,6967,8516.2,56.975459249847326,48207,123327.41141696177,123327.41141696177,48207,47.59664124539384,64.28571428571429,0,-0.39685180910919726,10.697251148303224,11.09410295741242,56.975459249847326,42.144236960721166,45.1801051306979
1437177600,280.14,282.71,276.34,277.71,4245,8516.9,4245,8516.9,54.94623269520165,43962,120908.36118148296,120908.36118148296,43962,46.295263343988466,57.142857142857146,0,-1.1664533085487196,9.636036321726522,10.802489630275241,54.94623269520165,32.53954458543365,38.80831933891435
1437264000,277.71,278.48,275,275.61,3441,8169.95,3441,8169.95,53.44626419805706,40521,118673.68876768988,118673.68876768988,40521,44.90321794210993,50,0,-1.8201785387945009,8.527266456782115,10.347444995576616,53.44626419805706,21.49299558625983,32.05892571080489
1437350400,275.6,280,273.34,280,5449,7842.8,5449,7842.8,56.14168203260223,45970,124122.68876768988,124122.68876768988,45970,43.3767010492679,42.857142857142854,14.285714285714286,-1.9486802183560545,7.911594722631548,9.860274940987603,56.14168203260223,29.917482249088444,27.983340806927316
1437436800,279.96,281.27,276.85,277.32,4908,7676.9,4908,7676.9,54.08300905510557,41062,120258.47157311969,120258.47157311969,41062,42.07301292961992,35.714285714285715,7.142857142857143,-2.187995128033977,7.125281030945132,9.313276158979109,54.08300905510557,24.774515448090536,25.394997761146282
1437523200,277.33,278.54,275.01,277.89,4651,7596.45,4651,7596.45,54.465452930016376,45713,123196.63871192982,123196.63871192982,45713,40.58107264653574,28.571428571428573,0,-2.271826049635253,6.473493596935043,8.745319646570296,54.465452930016376,21.83326588425733,25.508421193812115
1437609600,277.96,279.75,276.28,277.39,5262,7621.6,5262,7621.6,54.040254640585424,40451,121301.10557071946,121301.10557071946,40451,39.318476710373204,21.428571428571427,0,-2.316915013475729,5.849175879725635,8.166090893201364,54.040254640585424,17.655723905723885,21.421168412690594
1437696000,277.23,291.52,276.43,289.12,7324,7786.1,7324,7786.1,61.61174613007381,47775,126295.40378145507,126295.40378145507,47775,39.17019513387278,14.285714285714286,0,-1.5495868842882654,6.229107287841032,7.778694172129297,61.61174613007381,37.55697356426622,25.681987784749158
1437782400,289.12,291.67,286.82,289.7,4051,7567.65,4051,7567.65,61.94557481820738,51826,127055.48831753751,127055.48831753751,51826,39.043917700751344,7.142857142857143,42.857142857142854,-1.0213111984155647,6.502055174109842,7.523366372525406,61.94557481820738,38.87876025524158,31.36381924174391
1437868800,289.68,294.49,288.65,293.89,3682,7252.55,3682,7252.55,64.35698163716357,55508,129980.91297507174,129980.91297507174,55508,39.145835627689834,0,35.714285714285715,-0.4378524959917325,6.976050752535741,7.413903248527474,64.35698163716357,52.76881052892968,43.06818144947918
1437955200,293.88,297,287.24,294.21,6432,7226.95,6432,7226.95,64.54178201834881,61940,132735.60149966186,132735.60149966186,61940,39.43129742811451,0,28.571428571428573,-0.09636842173474491,7.2934427213590425,7.389811143093787,64.54178201834881,85.79952267303103,59.149031152400774
1438041600,294.22,298,293.65,295.76,5746,7126.1,5746,7126.1,65.47551353702583,67686,132563.88195943198,132563.88195943198,67686,39.77309103254118,100,21.428571428571427,0.15426485358878494,7.582642210079769,7.428377356490984,65.47551353702583,91.16719242902205,76.57850854366093
1438128000,295.74,296.58,289.01,290.19,5194,7038.7,5194,7038.7,59.420063750671645,62492,128989.14748122856,128989.14748122856,62492,39.20194006535946,92.85714285714286,14.285714285714286,-0.11991736941870368,7.278480644717604,7.3983980141363075,59.420063750671645,69.20347003154575,82.05672837786629
1438214400,290.26,291.56,286.56,288.49,5080,6499.6,5080,6499.6,57.667095770099024,57412,127830.90748122857,127830.90748122857,57412,38.23150230457533,85.71428571428571,7.142857142857143,-0.46142301930352936,6.821619240006896,7.283042259310426,57.667095770099024,62.50000000000006,74.29022082018929
1438300800,288.49,290,282.79,285.19,5637,6357.65,5637,6357.65,54.31722432570779,51775,125946.69527595809,125946.69527595809,51775,36.68518676951724,78.57142857142857,0,-0.9282799841162994,6.122692279165051,7.05097226328135,54.31722432570779,48.05352798053532,59.91899933736039
1438387200,285.2,285.6,277.26,281.53,3890,5907.4,3890,5907.4,50.79305911638744,47885,126039.98064766069,126039.98064766069,47885,34.39989759929837,71.42857142857143,14.285714285714286,-1.470089932246104,5.21335984797372,6.683449780219824,50.79305911638744,33.211678832116746,47.92173560421738
1438473600,281.53,282.62,277.33,282.62,3326,5426.6,3326,5426.6,51.796127893240104,51211,129365.98064766069,129365.98064766069,51211,32.27784336980943,64.28571428571429,7.142857142857143,-1.7239918500009193,4.528459967718675,6.252451817719594,51.796127893240104,37.631792376318,39.63233306299003
1438560000,282.62,285.86,280.27,280.95,4745,5308.1,4745,5308.1,50.110702648571745,46466,125775.39925231185,125775.39925231185,46466,30.7486376592864,57.142857142857146,0,-1.956336059923255,3.807031742815525,5.76336780273878,50.110702648571745,25.83732057416266,32.22693059419914
1438646400,280.95,286.47,280.11,285.51,5559,5208.25,5559,5208.25,54.46749442612748,52025,129656.2105730665,129656.2105730665,52025,29.411246141976477,50,7.142857142857143,-1.7609455176129662,3.562185905722572,5.323131423335538,54.46749442612748,45.67203131796431,36.380381422815
1438732800,285.6,286.25,282.01,282.77,5740,5066.45,5740,5066.45,51.55413971478259,46285,125973.94642212309,125973.94642212309,46285,28.169382590188697,42.857142857142854,0,-1.76955720912955,3.1111849119236012,4.880742121053151,51.55413971478259,29.880294659300187,33.79654885047572
1438819200,282.44,282.61,278.95,279.65,5020,4969.1,5020,4969.1,48.38079204553975,41265,122874.16500135802,122874.16500135802,41265,26.45472016452755,35.714285714285715,0,-1.9257996429558988,2.473492567358278,4.399292210314177,48.38079204553975,14.928140936485727,30.160155637916745
1438905600,279.37,281.17,277.05,279.94,5173,5015.5,5173,5015.5,48.696893042698775,46438,124958.43199164924,124958.43199164924,46438,24.6011313269947,28.571428571428573,0,-1.9443761588659108,1.9688220117317883,3.913198170597699,48.696893042698775,13.794749403341232,19.534394999709054
1438992000,280.06,280.16,260.07,262.02,6054,5146.15,6054,5146.15,34.597880093636036,40384,120079.67340528786,120079.67340528786,40384,25.021666939827764,21.428571428571427,100,-3.033380564344455,0.1214724651671304,3.1548530295115853,34.597880093636036,5.141049301344551,11.287979880390509
1439078400,262.02,268.8,260.97,267.63,5029,5125.15,5029,5125.15,40.41409610048069,45413,123605.75386505795,123605.75386505795,45413,25.412164294601318,14.285714285714286,92.85714285714286,-3.2276777054150556,-0.8797441022572343,2.3479336031578213,40.41409610048069,19.931452675982076,12.955750460222626
1439164800,267.6,268.89,263.17,265.15,5442,5151.85,5442,5151.85,38.772573622674855,39971,121931.29232659636,121931.29232659636,39971,25.757534298878543,7.142857142857143,85.71428571428571,-3.359932659221313,-1.8519822208688197,1.507950438352493,38.772573622674855,13.39309253888738,12.821864838738009
1439251200,265.15,271.99,264.91,271.99,5764,5207.5,5764,5207.5,45.364034660309095,45735,127695.29232659636,127695.29232659636,45735,25.481073049639086,0,78.57142857142857,-2.8439291558322437,-2.0469610064378116,0.7969681493944321,45.364034660309095,32.64858942755415,21.991044880807873
1439337600,271.99,272.4,265.79,266.94,6296,5259.2,6296,5259.2,41.78719961520479,39439,123590.03362765533,123590.03362765533,39439,25.145484765544868,0,71.42857142857143,-2.70096969960763,-2.579243975115105,0.12172572449252461,41.78719961520479,21.81644966656082,22.619377211000792
1439424000,266.81,267.82,262.94,264.67,5304,5158.2,5304,5158.2,40.250879301183055,34135,122046.65657847504,122046.65657847504,34135,25.193239705319666,0,64.28571428571429,-2.615752034297603,-3.147964318379479,-0.5322122840818763,40.250879301183055,15.369194787838362,23.278077960651117
1439510400,264.48,267.98,262.5,266.17,6837,5297.5,6837,5297.5,41.77424345063152,40972,124367.24416971592,124367.24416971592,40972,25.292954013034603,0,57.142857142857146,-2.324638635128533,-3.438010577992543,-1.1133719428640096,41.77424345063152,23.106060606060662,20.09723502015329
1439596800,266.21,267.69,261.77,262.46,4075,5317.15,4075,5317.15,39.1177232874028,36897,121242.15971025646,121242.15971025646,36897,25.481648984391303,21.428571428571427,50,-2.2469261310808832,-3.922029606715114,-1.6751034756342305,39.1177232874028,9.053030303030239,15.842761898976427
1439683200,262.45,263.1,255.67,259.2,5471,5269.1,5471,5269.1,36.89733997385241,31426,120969.71421900477,120969.71421900477,31426,26.38564530113286,14.285714285714286,100,-2.2732038438318685,-4.516608280424066,-2.2434044365921975,36.89733997385241,11.46103896103895,14.540043290043288
1439769600,259.2,261.57,255.58,257.31,6929,5328.25,6929,5328.25,35.63448421455654,24497,118043.10820898804,118043.10820898804,24497,27.234988316561786,7.142857142857143,100,-2.2706717979105546,-5.0817441839803905,-2.811072386069836,35.63448421455654,5.600517966979569,8.70486241034959
1439856000,257.56,258.04,200,221.99,11514,5644.25,11514,5644.25,21.100295341001313,12983,115253.87940126922,115253.87940126922,12983,30.663813007840883,0,100,-4.37846426850979,-8.284152721707073,-3.9056884531972837,21.100295341001313,25.495652173913054,14.185736367310527
1439942400,221.99,238.99,214.91,227.34,13300,6055.25,13300,6055.25,26.022267030427642,26283,115684.69335475759,115684.69335475759,26283,33.8477216497429,0,92.85714285714286,-5.093029504809012,-10.271975334208548,-5.178945829399536,26.022267030427642,33.095266916838156,21.39714568591026
1440028800,227.46,238.2,227.45,235.56,8796,6213.2,8796,6213.2,32.94384477771993,35079,120160.42544778087,120160.42544778087,35079,36.804208245794776,0,85.71428571428571,-4.702123471883853,-11.056600169254352,-6.354476697370499,32.94384477771993,43.80928914623629,34.1334027456625
1440115200,235.56,236.99,231.15,232.85,8286,6433,8286,6433,31.88466873463618,26793,116698.46654367125,116698.46654367125,26793,39.54951722784294,0,78.57142857142857,-4.3256313791265955,-11.761515921278743,-7.435884542152148,31.88466873463618,40.98053892215567,39.29503166174337
1440201600,232.85,235.53,222.68,231.15,7141,6623.75,7141,6623.75,31.206858332642184,19652,118971.36070709539,118971.36070709539,19652,42.292096776859104,0,71.42857142857143,-3.9035951730940877,-12.315378508519757,-8.41178333542567,31.206858332642184,43.02486187845306,42.60489664894834
1440288000,231.16,233.25,226.15,229.21,4271,6600.05,4271,6600.05,30.41232265839608,15381,118381.84239723624,118381.84239723624,15381,44.83877778665984,21.428571428571427,64.28571428571429,-3.4815557907993924,-12.76372807392491,-9.282172283125517,30.41232265839608,40.34530386740334,41.45023488933736
1440374400,229.23,229.24,210,211.16,16522,7148.2,16522,7148.2,24.230847637413774,-1141,103852.10019349403,103852.10019349403,-1141,47.51025357870326,14.285714285714286,57.142857142857146,-4.10180581370097,-14.40942955025173,-10.30762373655076,24.230847637413774,15.414364640883976,32.92817679558013
1440460800,211.16,229.49,198.02,223.73,19666,7844.5,19666,7844.5,34.25300448759813,18525,116319.10686651593,116319.10686651593,18525,50.161660964232404,7.142857142857143,100,-3.379382400906916,-14.531851737684406,-11.15246933677749,34.25300448759813,34.56574347942995,30.108470662572426
1440547200,223.73,231.97,220.16,226.81,9706,8078.8,9706,8078.8,36.47040910421978,28231,117543.65724754895,117543.65724754895,28231,52.239489433061756,0,92.85714285714286,-2.451195253131786,-14.216463403192222,-11.765268150060436,36.47040910421978,41.15208690680387,30.3773983423726
1440633600,226.72,229.99,224,225.8,7836,8211.95,7836,8211.95,36.04114657959055,20395,114417.10632935198,114417.10632935198,20395,54.16890158268901,7.142857142857143,85.71428571428571,-1.6981239618259565,-13.887923102342882,-12.189799140516925,36.04114657959055,39.70840480274442,38.47541172965942
1440720000,225.62,236.18,221.2,231.55,9109,8364.7,9109,8364.7,40.34595096623872,29504,117895.30926660166,117895.30926660166,29504,54.9647357799862,0,78.57142857142857,-0.6590113628671812,-13.013563344100902,-12.35455198123372,40.34595096623872,48.12688388115402,42.99579186356744
1440806400,231.55,233.95,228,230.61,4436,8335.05,4436,8335.05,39.87347305525227,25068,117351.06052710589,117351.06052710589,25068,55.703724677476444,0,71.42857142857143,0.07947623595800479,-12.255206686286215,-12.33468292224422,39.87347305525227,50.076828518746154,45.97070573421487
1440892800,230.61,233.47,226.59,229.39,4954,8310.65,4954,8310.65,39.2313307927514,20114,116429.38610850122,116429.38610850122,20114,56.439812061749805,0,64.28571428571429,0.5727750802631189,-11.61871407191532,-12.19148915217844,39.2313307927514,49.362706530291085,49.18880631006376
1440979200,229.4,233,225.23,230.75,6956,8370.25,6956,8370.25,40.38391952408148,27070,119356.8146799298,119356.8146799298,27070,57.173054235437206,0,57.142857142857146,1.0498789251555571,-10.879140495733992,-11.92901942088955,40.38391952408148,54.531822725758055,51.32378592493177
1441065600,230.76,233.5,226.42,228.22,8547,8482.8,8547,8482.8,38.90558444122444,18523,115155.74688331965,115155.74688331965,18523,57.75812928057731,0,50,1.241177887549636,-10.377547061452503,-11.61872494900214,38.90558444122444,73.71247254088355,59.2023339323109
1441152000,228.22,231.43,226.43,229.97,7450,8590.1,7450,8590.1,40.52733489154229,25973,118254.94688331963,118254.94688331963,25973,58.301413251064545,0,42.857142857142854,1.513622384508583,-9.726696968366412,-11.240319352874995,40.52733489154229,79.51717272274766,69.25382266312975
1441238400,229.95,230.79,226.48,227.25,6651,8580.8,6651,8580.8,38.80322146567677,19322,113980.4062800714,113980.4062800714,19322,58.80589122365984,0,35.714285714285715,1.53393053090522,-9.322906189243469,-10.856836720148689,38.80322146567677,75.00641519117268,76.07868681826797
1441324800,227.24,232.49,227.24,231.39,7040,8729.05,7040,8729.05,42.79243575549521,26362,118070.3110419761,118070.3110419761,26362,58.88415163622172,0,28.571428571428573,1.8294329466974624,-8.57004553677686,-10.399478483474322,42.79243575549521,87.44758909853245,80.65705900415094
1441411200,231.43,237.24,230.12,236.01,5567,8733.85,5567,8733.85,46.94850477824389,31929,121713.88126669519,121713.88126669519,31929,57.92417006659682,100,21.428571428571427,2.308393905108229,-7.513986102089035,-9.822380007197264,46.94850477824389,96.86384497705248,86.4392830889192
1441497600,236.17,244.82,235.54,241.29,5213,8648.05,5213,8648.05,51.30272678721755,37142,122960.95669772966,122960.95669772966,37142,55.635635953888915,100,14.285714285714286,2.914093560434182,-6.1797630566545365,-9.093856617088719,51.30272678721755,92.45726495726495,92.25623301094997
1441584000,241.26,242.98,239.21,241.31,4860,8315.35,4860,8315.35,51.319025486989375,42002,123515.28030515673,123515.28030515673,42002,53.51056856351729,92.85714285714286,7.142857142857143,3.225156078480893,-5.062411518987602,-8.287567597468495,51.319025486989375,92.50000000000001,93.94036997810582
1441670400,241.31,247.82,240.31,244.14,8251,8062.9,8251,8062.9,53.68137989361164,50253,123680.0805714683,123680.0805714683,50253,50.722914532549076,100,0,3.5072161879912525,-3.9035473624794292,-7.410763550470682,53.68137989361164,86.69558929862615,90.55095141863039
1441756800,244.24,244.69,238.6,238.75,6773,7961.75,6773,7961.75,48.82192351794286,43480,117240.72589166535,117240.72589166535,43480,48.33786005340908,92.85714285714286,0,3.2237372409677203,-3.381091999261031,-6.604829240228751,48.82192351794286,65.92787377911348,81.70782102591322
1441843200,238.74,241.4,236.69,238.52,5780,7836.45,5780,7836.45,48.61966828706957,37700,115952.19085981823,115952.19085981823,37700,46.35066072975798,85.71428571428571,7.142857142857143,2.922601400482698,-2.951577489625379,-5.874178890108077,48.61966828706957,65.06386175807671,72.5624416119388
1441929600,238.55,241.54,238.5,240.9,5812,7770,5812,7770,50.88700040707123,43512,119317.03296508144,119317.03296508144,43512,44.4793040831582,78.57142857142857,0,2.7860875023993854,-2.3915695121088447,-5.17765701450823,50.88700040707123,69.36697653829134,66.78623735849386
1442016000,240.9,241.12,235.26,236.5,5456,7829.25,5456,7829.25,46.77726845240202,38056,116170.05685586644,116170.05685586644,38056,43.14232076969728,71.42857142857143,14.285714285714286,2.3208779150032024,-2.2765596207542274,-4.59743753575743,46.77726845240202,49.88933156263837,61.44005661966883
1442102400,236.5,236.91,229.72,230.82,4976,7251.95,4976,7251.95,42.05545012223337,33080,112716.61596574125,112716.61596574125,33080,42.508272575757616,64.28571428571429,7.142857142857143,1.5870589328129263,-2.613613869741272,-4.200672802554198,42.05545012223337,24.745462594068183,48.00059023166599
1442188800,230.83,233.99,228.01,231.01,7967,6667,7967,6667,42.26539272674053,41047,112743.26145069106,112743.26145069106,41047,42.09174216699901,57.142857142857146,0,1.0943412476919918,-2.8327462429392085,-3.9270874906312003,42.26539272674053,21.44859813084113,32.02779742918259
1442275200,231.02,232.43,230.26,230.6,7085,6535.95,7085,6535.95,41.912496949919415,33962,107878.4457824883,107878.4457824883,33962,41.704963930294596,50,0,0.7377854365406553,-3.0048556949553813,-3.7426411314960366,41.912496949919415,19.495091164095324,21.89638396300157
1442361600,230.67,232,226.85,229.73,7616,6524.95,7616,6524.95,41.12777314561434,26346,108780.53510287663,108780.53510287663,26346,41.69951667504069,42.857142857142854,0,0.4542268072960671,-3.174857622375953,-3.62908442967202,41.12777314561434,15.229615745079661,18.724435013338727
1442448000,229.72,235.93,229.01,233.34,7498,6444.4,7498,6444.4,45.67305876115933,33844,110665.87036299224,110665.87036299224,33844,40.79946021536866,35.714285714285715,0,0.5161538685122653,-2.983892094031688,-3.5000459625439535,45.67305876115933,30.948974725798806,21.891227211657952
1442534400,233.31,234.96,231.75,233.78,4641,6454.65,4641,6454.65,46.21808465748167,38485,111894.7955966371,111894.7955966371,38485,39.963693502816064,28.571428571428573,85.71428571428571,0.587899935085161,-2.765171043687502,-3.353070978772663,46.21808465748167,33.04721030042922,26.40860025710258
1442620800,233.78,234.31,232,232.88,3553,6384.6,3553,6384.6,45.21878601120997,34932,111048.8432156847,111048.8432156847,34932,39.187624412588654,21.428571428571427,78.57142857142857,0.5751837042376904,-2.6340913484755504,-3.2092750527132408,45.21878601120997,28.75536480686696,30.917183277698353
1442707200,232.88,234,231.84,232.24,3633,6218.45,3633,6218.45,44.482252895609825,31299,108761.39877124027,108761.39877124027,31299,38.489669562628634,14.285714285714286,71.42857142857143,0.5254763800903128,-2.55242957760035,-3.0779059576906627,44.482252895609825,25.70338578922277,29.168653632173005
1442793600,232.26,233.64,226.87,227.31,7565,6169.35,7565,6169.35,39.18721139995399,23734,102179.73702825652,102179.73702825652,23734,38.49847167831849,7.142857142857143,64.28571428571429,0.18021405062741191,-2.852638394406398,-3.03285244503381,39.18721139995399,2.193609918931845,18.88412017167388
1442880000,227.31,232.5,224.45,231.28,8867,6240.2,8867,6240.2,44.87756504144954,32601,108359.09976117578,108359.09976117578,32601,38.7870687663529,0,100,0.23536925521635732,-2.7386408760133634,-2.9740101312297207,44.87756504144954,33.7450592885376,20.547351665564094
1442966400,231.31,233,229.27,230.26,6309,6223.1,6309,6223.1,43.74498994401922,26292,105399.11316600147,105399.11316600147,26292,38.91220394732872,0,92.85714285714286,0.21962048921501687,-2.69948451971095,-2.9191050089259667,43.74498994401922,33.996489174956125,23.311719460808543
1443052800,230.26,235.99,230.09,235.27,9325,6337.35,9325,6337.35,50.3702381342733,35617,112448.18096261164,112448.18096261164,35617,38.196531861977164,7.142857142857143,85.71428571428571,0.5445760177241588,-2.238384986770768,-2.782961004494927,50.3702381342733,63.3118782913986,43.684475584964126
1443139200,235.35,237.62,234.02,235.89,6156,6366.8,6156,6366.8,51.13717247942769,41773,112687.58096261157,112687.58096261157,41773,37.104852048545915,0,78.57142857142857,0.7846429486651045,-1.8021573186635464,-2.586800267328651,51.13717247942769,68.6262747450509,55.31154740380189
1443225600,235.88,236.2,233.5,234.69,4107,6311.5,4107,6311.5,49.541444354644874,37666,112200.82540705602,112200.82540705602,37666,36.17753518608101,0,71.42857142857143,0.8409821378588811,-1.5355725950050498,-2.376554732863931,49.541444354644874,77.75246772968866,69.89687358871275
1443312000,234.67,235.03,233.2,233.58,3248,6230.9,3248,6230.9,48.04788368657905,34418,110301.72158191948,110301.72158191948,34418,35.36877487888287,85.71428571428571,64.28571428571429,0.7830377658679772,-1.3977575255289594,-2.1807952913969366,48.04788368657905,69.32422171602136,71.900988063587
1443398400,233.53,240.52,233.53,239.99,8080,6222.35,8080,6222.35,56.25041466643055,42498,117156.42830581075,117156.42830581075,42498,33.192320306534924,100,57.142857142857146,1.1346243419434727,-0.7625148639675956,-1.8971392059110683,56.25041466643055,96.70192906036092,81.25953950202366
1443484800,239.96,241.05,236.65,236.89,6938,6230.6,6938,6230.6,51.976371161627014,35560,110975.30103308342,110975.30103308342,35560,31.04885109267191,100,50,1.114974211754777,-0.503421441217597,-1.618395652972374,51.976371161627014,74.93975903614447,80.32196993750894
1443571200,236.88,238.75,236.26,237.14,5447,6213.95,5447,6213.95,52.291200140043074,41007,109378.38938649705,109378.38938649705,41007,29.146919583087477,92.85714285714286,42.857142857142854,1.0749181204491205,-0.2747480024109734,-1.349666122860094,52.291200140043074,76.44578313253,82.69582374301181
1443657600,237.1,239.86,236.9,238.34,5625,6204.6,5625,6204.6,53.854962134149204,46632,109226.36235946999,109226.36235946999,46632,27.099519454087286,85.71428571428571,35.714285714285715,1.0823485993369966,0.0032696263111517965,-1.0790789730258448,53.854962134149204,83.67469879518069,78.35341365461841
1443744000,238.34,239.4,236.97,238.28,5870,6225.3,5870,6225.3,53.76007949589732,40762,109685.33355288563,109685.33355288563,40762,25.19836219144425,78.57142857142857,28.571428571428573,1.0362760746681041,0.21626612030928527,-0.8200099543588187,53.76007949589732,83.31325301204816,81.14457831325298
1443830400,238.31,240.62,237.73,239.92,4288,6190.9,4288,6190.9,56.03988165693274,45050,111896.10171897555,111896.10171897555,45050,23.693200108238994,71.42857142857143,21.428571428571427,1.0652122474683625,0.5115053549766344,-0.5537068924917281,56.03988165693274,93.19277108433722,86.72690763052204
1443916800,239.93,240.28,239.07,239.87,3741,5979.6,3741,5979.6,55.94931138586214,41309,113101.87857847972,113101.87857847972,41309,22.29554960240554,64.28571428571429,14.285714285714286,1.0293658506553096,0.733000420827409,-0.29636542982790065,55.94931138586214,92.8915662650602,89.79919678714856
1444003200,239.87,240.98,237.5,240.95,7456,5998.15,7456,5998.15,57.54538103803238,48765,120429.32685434178,120429.32685434178,48765,20.884865653834822,57.142857142857146,7.142857142857143,1.0245619487308542,0.9843370060856671,-0.04022494264518711,57.54538103803238,99.39759036144565,95.16064257028104
1444089600,240.93,248,240.31,246.64,17590,6496.85,17590,6496.85,64.78478314052926,66355,131797.63634718957,131797.63634718957,66355,20.938359555252525,100,0,1.3313309559571551,1.6239387523012567,0.29260779634410167,64.78478314052926,92.73892151628397,95.00935938092995
1444176000,246.7,247.96,240.2,244,17600,7001.95,17600,7001.95,59.69831671935697,48755,131434.74974925144,131434.74974925144,48755,20.953599447190836,92.85714285714286,0,1.2826709760479604,1.8959465164040523,0.6132755403560919,59.69831671935697,77.66610831937464,89.93420673236811
1444262400,244,245.38,242.2,242.94,11223,7331.05,11223,7331.05,57.738151539190206,37532,125435.03276811942,125435.03276811942,37532,20.967750775419265,85.71428571428571,0,1.1116942715794667,2.002893379830425,0.8911991082509585,57.738151539190206,65.81081081081082,78.73861354882317
1444348800,242.94,244.88,241.1,244.35,9836,7645.2,9836,7645.2,59.63667283651525,47368,132512.78938187603,132512.78938187603,47368,20.60061167269672,78.57142857142857,14.285714285714286,1.0281105487118567,2.1763372941407795,1.1482267454289228,59.63667283651525,75.33783783783781,72.93825232267444
1444435200,244.44,246.1,243.8,246.07,7348,7830.95,7348,7830.95,61.88596529745731,54716,139669.1024253543,139669.1024253543,54716,20.55952821508595,71.42857142857143,7.142857142857143,1.0211248543741296,2.4246328133965847,1.403507959022455,61.88596529745731,86.95945945945942,76.03603603603604
1444521600,246.06,250,245.63,249.02,8603,7882.85,8603,7882.85,65.44288974593888,63319,144413.54864961063,144413.54864961063,63319,21.358407028531015,100,0,1.1386838984092893,2.8268628320340667,1.6881789336247774,65.44288974593888,94.0497874924105,85.44902826323595
1444608000,249.01,249.14,245.89,246.39,10749,7976.95,10749,7976.95,60.061387883177574,52570,136971.93326499526,136971.93326499526,52570,22.100223069587145,92.85714285714286,0,0.9694446772394989,2.899984780174151,1.930540102934652,60.061387883177574,73.72634643376993,84.91186446187999
1444694400,246.43,251.5,244.86,250.99,12957,8309.35,12957,8309.35,65.41786864488952,65527,147938.5507348748,147938.5507348748,65527,23.243660063797993,100,7.142857142857143,1.0885098081570317,3.2911773631309416,2.20266755497391,65.41786864488952,96.65354330708668,88.1432257444224
1444780800,250.98,255,250.25,253.27,15155,8600.85,15155,8600.85,67.72818608193379,80682,152054.3296822433,152054.3296822433,80682,24.878452063973867,100,0,1.2314990165782578,3.742041325696732,2.5105423091184744,67.72818608193379,90.4419889502763,86.94062623037767
1444867200,253.25,256.77,253.18,254.99,13351,8960.6,13351,8960.6,69.38956133254727,94033,152165.89792736876,152165.89792736876,94033,26.650191003482142,100,0,1.3434429156051717,4.189845953624939,2.8464030380197674,69.38956133254727,91.01010101010114,92.7018777558214
1444953600,254.98,267.6,254.86,263.43,18411,9675.8,18411,9675.8,75.9360682377698,112444,158524.48505452726,158524.48505452726,112444,29.38397983665511,100,0,1.8558526546852976,5.166218856376389,3.3103662016910915,75.9360682377698,86.14617940199332,89.19942312079029
1445040000,263.45,274.81,263.05,272.87,22028,10614.8,22028,10614.8,80.86527046404822,134472,173284.74355792862,173284.74355792862,134472,32.3695083946887,100,14.285714285714286,2.6519930589759304,6.625357525411005,3.9733644664350742,80.86527046404822,94.80032162958993,90.6522006805615
1445126400,272.88,273.5,262.94,265,11288,10775.2,11288,10775.2,68.30375469813812,123184,166400.77386095893,166400.77386095893,123184,35.106047306170964,92.85714285714286,7.142857142857143,2.4735071625832896,7.0652484196641865,4.591741257080897,68.30375469813812,73.70678102385419,84.8844273518125
1445212800,265,268.23,262.05,265.17,10708,10963.7,10708,10963.7,68.41787953309846,133892,166504.7350260075,166504.7350260075,133892,37.34434796614717,85.71428571428571,0,2.200957302125847,7.342937884738205,5.141980582612359,68.41787953309846,72.14677838774925,80.21796034706449
1445299200,265.09,272.95,264.38,271.14,9290,11155.85,9290,11155.85,72.20300504228766,143182,171870.6043375594,171870.6043375594,143182,39.72052153288206,78.57142857142857,7.142857142857143,2.248863508609853,7.953059968374674,5.704196459764821,72.20300504228766,89.39612828662233,78.41656256607529
1445385600,271.16,272.85,265,268.77,12377,11493.45,12377,11493.45,68.68374264337805,130805,171381.83108915167,171381.83108915167,130805,41.92696841627875,71.42857142857143,0,1.957749116008161,8.151382854775022,6.193633738766861,68.68374264337805,82.08246811035295,81.20845826157488
1445472000,268.77,280,268.75,275.84,16532,12026.55,16532,12026.55,72.92353081190412,147337,175687.49864470714,175687.49864470714,147337,44.3518674815217,100,7.142857142857143,2.0673805175153586,8.77785938566106,6.710478868145701,72.92353081190412,89.30591259640097,86.92816966445878
1445558400,275.76,281.17,275.4,278.76,7045,12164.4,7045,12164.4,74.46140038890704,154382,176847.42065510573,176847.42065510573,154382,46.65629308876437,100,0,2.152889276578695,9.40159046386907,7.248701187290375,74.46140038890704,93.55097671929349,88.31311914201582
1445644800,278.76,284.49,278.75,284.29,5469,12250.8,5469,12250.8,77.11264633957565,159851,181935.30567252735,181935.30567252735,159851,48.93897349427846,100,0,2.3804531526629296,10.224267628119037,7.843814475456107,77.11264633957565,99.49533181932883,94.11740704500778
1445731200,284.29,295.93,283.28,284.97,10682,12412.1,10682,12412.1,77.42302168750089,170533,174107.46851837722,174107.46851837722,170533,51.42660299110189,100,14.285714285714286,2.370183945848332,10.806544407766523,8.436360461918191,77.42302168750089,78.5392598394361,90.52852279268616
1445817600,284.97,287.68,282.04,287.1,7443,11904.75,7443,11904.75,78.41063488354007,177976,180019.6387311432,180019.6387311432,177976,53.37752940459616,92.85714285714286,7.142857142857143,2.2985173829395933,11.309507190592683,9.01098980765309,78.41063488354007,82.71000587429022,86.91486584435175
1445904000,287.1,297.99,286.89,295.61,11109,11580.2,11109,11580.2,81.83043178937274,189085,186364.77927168377,186364.77927168377,189085,55.48785236306243,100,0,2.594042935445282,12.253543476959692,9.65950054151441,81.83043178937274,95.01466275659826,85.42130949010823
1445990400,295.68,308.93,295.65,304.09,16030,11820.55,16030,11820.55,84.47025968100931,205115,190710.26119939456,190710.26119939456,205115,57.671333756747536,100,0,3.0963985759188475,13.529998761412969,10.433600185494122,84.47025968100931,91.31838565022414,89.68101809370422
1446076800,304.1,320.99,301.8,316.08,12221,11939.8,12221,11939.8,87.28349885047317,217336,196677.47172571032,196677.47172571032,217336,59.87704204272914,100,0,3.918999677097469,15.332349781865958,11.413350104768488,87.28349885047317,92.57523060638134,92.9694263377346
1446163200,316.07,336.97,315.9,329.11,16831,12413.95,16831,12413.95,89.50790713421675,234167,200951.12383771793,200951.12383771793,234167,62.09151711367529,100,0,4.956640497226903,17.60915072630212,12.652510229075215,89.50790713421675,89.50880939668978,91.13414188443177
1446249600,329.11,334.28,306.29,314.85,15208,12744.2,15208,12744.2,74.20891726149354,218959,195045.0516690863,195045.0516690863,218959,62.56097563418563,92.85714285714286,14.285714285714286,4.321787968869298,18.05474519016184,13.73295722129254,74.20891726149354,70.47517351841964,84.18640450716362
1446336000,314.84,332,311.44,329.46,10685,12741,10685,12741,78.30109546204135,229644,203089.98357570107,203089.98357570107,229644,62.99690140323095,85.71428571428571,7.142857142857143,4.504494755268135,19.36357566537771,14.859080910109574,78.30109546204135,89.97597437266411,83.3199857625912
1446422400,329.45,371.82,326.07,365.21,19736,13079.95,19736,13079.95,84.69876664231147,249380,217123.03450466282,217123.03450466282,249380,64.20453881863239,100,0,6.528892848141194,23.020196970286065,16.49130412214487,84.69876664231147,93.84772896500371,84.76629228536251
1446508800,365.14,422.3,362.07,404.1,40153,14329.85,40153,14329.85,88.62705678297726,289533,233009.56928799342,233009.56928799342,289533,65.7977730921153,100,0,9.787011876162339,28.725068967347795,18.938057091185456,88.62705678297726,88.42975206611571,90.7511518012612
1446595200,404.06,499.99,368.15,410,50602,16192.4,50602,16192.4,89.0848866493992,340135,214532.77711566334,214532.77711566334,340135,67.61703850930397,100,0,11.519955992833172,33.33800208222692,21.81804608939375,89.0848866493992,61.08372253935305,81.12040119015752
1446681600,410,450,366.66,387.21,27224,16633.05,27224,16633.05,76.30665737820313,312911,200734.57985144446,200734.57985144446,312911,69.20755946007678,92.85714285714286,0,10.348921143583592,34.75419751887324,24.40527637528965,76.30665737820313,49.78405093726345,66.43250851424409
1446768000,387.21,395,351,374.09,20023,16532.8,20023,16532.8,70.07499503751195,292888,201726.62848780808,201726.62848780808,292888,69.6583132956916,85.71428571428571,0,8.01264564421676,34.4210834305606,26.40843778634384,70.07499503751195,43.093473151328865,51.32041554264848
1446854400,374.26,392,371.43,384.81,8348,16385.8,8348,16385.8,72.08123691166301,301236,204238.7393288387,204238.7393288387,301236,70.07687042876249,78.57142857142857,0,6.571641967206496,34.62299024535196,28.05134827814546,72.08123691166301,47.153016746960304,46.67684694518423
1446940800,384.8,389,363.58,373.83,7434,16222.1,7434,16222.1,67.1178371999299,293802,202799.9006191613,202799.9006191613,293802,69.93732816004403,71.42857142857143,7.142857142857143,4.367495711853401,33.51071791796221,29.14322220610881,67.1178371999299,42.11516402844688,44.12055130891205
1447027200,373.84,386.96,360.8,379.53,11187,16316.95,11187,16316.95,68.33674208628952,304989,207632.20566503284,207632.20566503284,304989,69.6178451748061,64.28571428571429,0,2.8550956881060365,32.712091816241355,29.856996128135318,68.33674208628952,43.472548099483795,44.2469096249637
1447113600,379.55,382.23,322,337.14,16665,16531.35,16665,16531.35,52.69313984517142,288324,199345.35940901423,199345.35940901423,288324,67.0514252737257,57.142857142857146,0,-1.2199474842460702,28.33206177282773,29.5520092570738,52.69313984517142,20.30439463639033,35.29736892144037
1447200000,337.14,341.75,293.32,313.2,18091,16609.3,18091,16609.3,46.25335773668585,270233,196106.68565307782,196106.68565307782,270233,63.40207870787188,50,100,-5.5073688341890445,22.667798214337495,28.17516704852654,46.25335773668585,9.619199690327573,24.465380808733936
1447286400,313.2,344.99,312.24,336.49,15753,17044.7,15753,17044.7,52.35397520062524,285986,203682.55588208546,203682.55588208546,285986,60.108703020558366,42.857142857142854,92.85714285714286,-6.676490329897483,19.829554136154684,26.506044466052167,52.35397520062524,20.888372768181167,16.93732236496639
1447372800,336.49,343,325,338.07,10186,17280.55,10186,17280.55,52.74583868640903,296172,208288.89143764102,208288.89143764102,296172,57.050568453767234,35.714285714285715,85.71428571428571,-7.20009901729663,17.50592069443138,24.70601971172801,52.74583868640903,21.65287656650699,17.386816341671945
1447459200,338.08,339.57,329.4,334.71,5970,17044.95,5970,17044.95,51.77071619910632,290202,208553.0507296764,208553.0507296764,290202,54.21087207031834,28.571428571428573,78.57142857142857,-7.59051312666157,15.21787830340105,22.80839143006262,51.77071619910632,20.027096337155843,20.856115223948034
1447545600,334.67,336.46,319.89,322.93,6290,16987.3,6290,16987.3,48.392846924040846,283912,204571.02900366558,204571.02900366558,283912,51.11319861929237,21.428571428571427,71.42857142857143,-8.397021716706927,12.31211428417896,20.709136000885888,48.392846924040846,14.327188271156922,18.669053724939953
1447632000,322.94,334.1,316.12,332.89,7261,16794.9,7261,16794.9,51.28687907178275,291173,210854.74201812607,210854.74201812607,291173,48.05514352684514,14.285714285714286,64.28571428571429,-8.015517230739384,10.68973946246166,18.705256693201044,51.28687907178275,19.146465379590644,17.833583329301174
1447718400,332.85,340.72,330.1,336.49,7225,16354.65,7225,16354.65,52.32749218343722,298398,212324.23354354978,212324.23354354978,298398,45.48787580100924,7.142857142857143,57.142857142857146,-7.2969996166647135,9.58400717237015,16.881006789034863,52.32749218343722,20.888372768181167,18.120675472976277
1447804800,336.49,338,330,335.49,5171,16002.15,5171,16002.15,51.995223834221925,293227,214250.4310435498,214250.4310435498,293227,43.09857108803809,0,50,-6.681844498949198,8.528701165348366,15.210545664297564,51.995223834221925,26.914730661220332,22.316522936330752
1447891200,335.5,336.38,324.9,326.41,6696,15495.4,6696,15495.4,48.95552012622507,286531,209315.92233274845,209315.92233274845,286531,40.5934552808967,0,42.857142857142854,-6.664139887688993,6.880370804686322,13.544510692375315,48.95552012622507,32.54327301337533,26.782125480925647
1447977600,326.53,327.04,311.23,322.39,9295,15199.75,9295,15199.75,47.62795860362032,277236,213143.27527392487,213143.27527392487,277236,37.84322731578021,0,35.714285714285715,-6.683727482574719,5.189851339156917,11.873578821731636,47.62795860362032,29.4588569112282,29.63895352860799
1448064000,322.39,328,316.33,327,5083,14919.65,5083,14919.65,49.32505242080234,282319,217355.1527375067,217355.1527375067,282319,35.23815721216306,0,28.571428571428573,-6.159682290053418,4.1739759591648635,10.333658249218281,49.32505242080234,35.200668896321076,32.40093294030824
1448150400,326.99,327,321,323.71,3370,14101.35,3370,14101.35,48.126464320993236,278949,217029.38607084,217029.38607084,278949,32.81916354451857,0,21.428571428571427,-5.812490295483126,3.0680453798643725,8.880535675347499,48.126464320993236,32.454079453225106,32.3712017535915
1448236800,323.72,326,322,323,4756,12331.5,4756,12331.5,47.856200597250336,274193,214651.38607084,214651.38607084,274193,30.572955138848673,0,14.285714285714286,-5.416449423456774,2.1099738960265313,7.526423319483305,47.856200597250336,33.38207175795748,33.67894003583459
1448323200,323.01,323.17,318,321,5190,10060.9,5190,10060.9,47.05459240738213,269003,215484.59690256146,215484.59690256146,269003,28.73593453362021,0,7.142857142857143,-5.080531740792791,1.1757586434923155,6.256290384285107,47.05459240738213,53.570737371782464,39.80229619432172
1448409600,320.96,330.06,316.26,328.98,7844,9091.9,7844,9091.9,50.609474154849586,276847,222100.84038082234,222100.84038082234,276847,26.797003668287754,7.142857142857143,0,-4.151427624020856,1.0670058542590368,5.218433478279893,50.609474154849586,52.577014218009495,46.50994111591652
1448496000,328.99,368.18,328.98,352.57,13997,8790.6,13997,8790.6,59.30750451864062,290844,224950.22966653662,224950.22966653662,290844,26.880933097585526,100,57.142857142857146,-1.8935752398575811,2.8514644284579163,4.745039668315497,59.30750451864062,72.58999122036872,59.57924760338693
1448582400,352.56,364.46,347.96,358.19,7196,8733,7196,8733,61.06661258012908,298040,226677.26966653662,226677.26966653662,298040,26.958867567647733,92.85714285714286,50,-0.06373711452798592,4.665368275155515,4.729105389683501,61.06661258012908,82.45829675153642,69.20843406330492
1448668800,358.2,359.63,351.09,357.24,5522,8637.4,5522,8637.4,60.589797841228524,292518,229108.50151665375,229108.50151665375,292518,27.031235289848354,85.71428571428571,42.857142857142854,0.9827700456795547,5.9575679467829445,4.97479790110339,60.589797841228524,80.79016681299386,78.61281826163304
1448755200,357.24,373.63,354.26,372.24,5493,8352.7,5493,8352.7,65.20898235766893,298011,233813.1411655954,233813.1411655954,298011,27.661803556652124,100,35.714285714285715,2.499092704145684,8.098663781285495,5.599571077139811,65.20898235766893,97.77243589743591,87.00696648732212
1448841600,372.25,382.87,367.5,376.86,11420,8090.45,11420,8090.45,66.51093466259033,309431,236302.21078173077,236302.21078173077,309431,28.57816120791112,100,28.571428571428573,3.562275187505863,10.05241506152214,6.490139874016277,66.51093466259033,91.61083193746512,90.05781154929834
1448928000,376.88,378.94,354.6,362.68,9241,7647.95,9241,7647.95,59.18956958692112,300190,233196.5665746642,233196.5665746642,300190,28.446279749107312,92.85714285714286,21.428571428571427,3.0778131797915664,10.337406348755735,7.259593168964169,59.18956958692112,71.81742043551088,87.06689609013735
1449014400,362.68,363.06,347.55,360,8919,7306.25,8919,7306.25,57.89249624081067,291271,238596.27063655976,238596.27063655976,291271,27.83048267362122,85.71428571428571,14.285714285714286,2.3756020619966796,10.229095746460018,7.853493684463339,57.89249624081067,68.07649357900613,77.16824865066076
1449100800,360,369.99,356.52,361.77,7195,7156.7,7195,7156.7,58.53872335968189,298466,237009.84524680473,237009.84524680473,298466,27.571037916292102,78.57142857142857,7.142857142857143,1.852295214002691,10.168862701966702,8.316567487964011,58.53872335968189,70.54718034617528,70.14703145356414
1449187200,361.89,364.85,355.43,363.98,5820,7149.2,5820,7149.2,59.377026481570354,304286,241754.81339967097,241754.81339967097,304286,27.24891185847893,71.42857142857143,0,1.4924127226698918,10.182083391301376,8.689670668631484,59.377026481570354,71.64089476054649,70.08818956190935
1449273600,363.98,390,363.97,387.99,8687,7269.05,8687,7269.05,67.14842497645836,312973,249100.21754872974,249100.21754872974,312973,27.968242573422934,100,28.571428571428573,2.6416506476557586,11.991733978201182,9.350083330545424,67.14842497645836,97.27420667209114,79.82076059293769
1449360000,388.03,401.01,375.22,387.57,9614,7386.7,9614,7386.7,66.90729967402916,303359,248693.88718812485,248693.88718812485,303359,28.995927873709288,100,21.428571428571427,3.1114446787733474,13.239389179012107,10.12794450023876,66.90729967402916,84.14159292035399,84.35223145099725
1449446400,387.53,397.57,383,394.73,7550,7402.95,7550,7402.95,68.95402990844434,310909,253300.57902065746,253300.57902065746,310909,29.950207081118048,92.85714285714286,14.285714285714286,3.607395340755371,14.637188676182973,11.029793335427602,68.95402990844434,92.58997050147495,91.3352566979734
1449532800,394.73,418.94,386.69,418.94,8225,7555.65,8225,7555.65,74.66077181379535,319134,261525.57902065746,261525.57902065746,319134,31.46697715420216,100,7.142857142857143,5.173611103412847,17.49680721469366,12.323196111280813,74.66077181379535,100,92.24385447394303
1449619200,417.84,425,401,418.39,13684,7905.05,13684,7905.05,74.32651570394718,305450,267671.9756873241,267671.9756873241,305450,33.03121399080358,100,0,5.736627616021822,19.49398063130809,13.757353015286268,74.32651570394718,93.1160174963549,95.23532933261
1449705600,418.39,419.5,408,415.68,7007,7790.65,7007,7790.65,72.60176883274497,298443,270023.8904699328,270023.8904699328,298443,34.483719624790616,92.85714285714286,0,5.490422929384364,20.620381677016724,15.12995874763236,72.60176883274497,87.96642995480957,93.69414915038821
1449792000,415.68,453.13,415.67,452.95,13628,8217.9,13628,8217.9,79.60958188945948,312071,283520.92197019974,283520.92197019974,312071,36.576483556825934,100,35.714285714285715,7.288836943762327,24.24100492733527,16.95216798357294,79.60958188945948,99.82951316537223,93.6373202055123
1449878400,452.95,469.34,403,436.87,29495,9524.15,29495,9524.15,71.15352775935646,282576,284143.3669506037,284143.3669506037,282576,38.78854384598015,100,28.571428571428573,6.853217416270873,25.51868975391153,18.665472337640658,71.15352775935646,73.33935462681667,87.04509924899953
1449964800,436.9,443.83,419.42,433.83,6675,9620.1,6675,9620.1,69.64733981515357,275901,285349.29689734685,285349.29689734685,275901,40.842599828766204,92.85714285714286,21.428571428571427,5.856747308043083,25.98640647269451,20.12965916465143,69.64733981515357,70.84325478282288,81.33737419167063
1450051200,433.38,450,429.12,444.01,165538,17637.5,165538,17637.5,71.80007017357644,441439,355909.07659083325,355909.07659083325,441439,42.85159749915087,85.71428571428571,14.285714285714286,5.391304334809433,26.86878958316322,21.477485248353787,71.80007017357644,79.201904918302,74.46150477598057
1450137600,444.03,464.95,443.76,464.27,10990,17794.8,10990,17794.8,75.52108489481132,452429,366193.72500989883,366193.72500989883,452429,44.944690137006035,78.57142857142857,7.142857142857143,5.914092350004239,28.870100685859086,22.956008335854847,75.52108489481132,95.83709664176041,81.96075211429515
1450224000,464.5,464.73,440,453.97,35946,18892.25,35946,18892.25,70.4328069735769,416483,370859.5826726567,370859.5826726567,416483,46.55554163073813,71.42857142857143,0,5.065131772876157,29.287423051950043,24.222291279073886,70.4328069735769,86.50689140549561,87.18196432185272
1450310400,453.96,456.33,446.01,455.5,6233,18844.1,6233,18844.1,70.74808650339303,422716,376089.9877114164,376089.9877114164,422716,48.05133230348936,64.28571428571429,7.142857142857143,4.144308172642194,29.40267649487663,25.258368322234436,70.74808650339303,87.8500570625933,90.06468170328314
1450396800,455.5,465.1,453.28,463.17,5022,18819.1,5022,18819.1,72.34037092422287,427738,379471.9775591321,379471.9775591321,427738,49.59862754809145,57.142857142857146,0,3.609108055664329,29.769753391814845,26.160645336150516,72.34037092422287,94.14444338995922,89.50046395268275
1450483200,463.14,465.6,451.58,461.29,6927,18890.8,6927,18890.8,71.31566680653711,420811,382140.0089428696,382140.0089428696,420811,50.86522854136008,50,0,2.7259807649661703,29.568121292358228,26.842140527392058,71.31566680653711,91.44708882277948,91.14719642511072
1450569600,461.29,461.3,430,442.22,8308,18735.2,8308,18735.2,61.75920794014948,412503,380319.1501569271,380319.1501569271,412503,50.11695406583273,42.857142857142854,0,0.5678357515285057,27.55193521680269,26.984099465274184,61.75920794014948,68.58929812369706,84.72694344547862
1450656000,442.36,444.44,424.66,436.81,6815,18613.9,6815,18613.9,59.33025275786372,405688,381876.47068271076,381876.47068271076,405688,49.00957152369903,35.714285714285715,0,-1.4058770663441358,25.226753132344015,26.63263019868815,59.33025275786372,60.64125831820933,73.55921508822867
1450742400,436.85,442,432.58,433.92,6609,18498.4,6609,18498.4,58.017561726697004,399079,377147.73819863435,377147.73819863435,399079,47.98128773457488,28.571428571428573,0,-2.9965012787288643,22.88700360027707,25.883504879005933,58.017561726697004,48.17091015510686,59.13382219900446
1450828800,433.94,445.11,428.29,442.43,7541,18515.7,7541,18515.7,60.77002037311676,406620,382285.6609096926,382285.6609096926,406620,46.67148662496106,21.428571428571427,0,-3.5292788251928258,21.471906347514903,25.00118517270773,60.77002037311676,59.43623756406395,56.08280201246009
1450915200,442.43,460,442.42,455.74,6810,18565.2,6810,18565.2,64.67135582326677,413430,385795.2513533786,385795.2513533786,413430,46.06461445677498,14.285714285714286,14.285714285714286,-3.056720769327292,21.180284211048615,24.237004980375907,64.67135582326677,79.49954778414234,62.36889850110443
1451001600,455.74,458.99,450.01,455.84,3421,18301.9,3421,18301.9,64.6997598229814,416851,386816.21794580616,386816.21794580616,416851,45.5010903006022,7.142857142857143,7.142857142857143,-2.814874562749406,20.71841177693915,23.533286339688555,64.6997598229814,79.65028640337654,72.86202391719432
1451088000,455.82,458.29,410,419.41,13484,18495.4,13484,18495.4,49.18543445006495,403367,378587.3200373365,378587.3200373365,403367,42.27109336987409,0,0,-5.055155642194617,17.214341786945283,22.2694974291399,49.18543445006495,16.924460431654715,58.69143153972458
1451174400,419.41,429.85,410.02,424.72,5506,18393.2,5506,18393.2,51.028716307410846,408873,381244.5272990612,381244.5272990612,408873,39.27181050562655,42.857142857142854,92.85714285714286,-6.058475771638538,14.696402714591727,20.754878486230265,51.028716307410846,26.47482014388493,41.01652232630544
1451260800,424.73,429.9,418,421.94,6899,18326.9,6899,18326.9,50.005987479448876,401974,378913.9407444393,378913.9407444393,401974,36.48959215020726,35.714285714285715,85.71428571428571,-6.736373450941844,12.33441167255296,19.070785123494804,50.005987479448876,21.47482014388488,21.62470023980822
1451347200,421.94,433.9,419.31,433.89,6337,17959.55,6337,17959.55,54.250608935868826,408311,385242.25397267786,385242.25397267786,408311,34.14175721992872,28.571428571428573,78.57142857142857,-6.219378380698462,11.296562147621728,17.51594052832019,54.250608935868826,42.967625899280534,30.30575539568349
1451433600,433.89,434.99,422.35,427.95,4832,17850.8,4832,17850.8,51.89216278175224,403479,384691.7729600196,384691.7729600196,403479,32.02784794078153,21.428571428571427,71.42857142857143,-6.108072204152089,9.88085027313008,15.988922477282168,51.89216278175224,32.28417266187047,32.242206235012006
1451520000,427.9,434,419.04,430.35,6448,17491.8,6448,17491.8,52.78527956500374,409927,387993.3558477201,387993.3558477201,409927,29.837176791368357,14.285714285714286,64.28571428571429,-5.710717972045844,8.850525012224864,14.561242984270708,52.78527956500374,36.60071942446046,37.284172661870535
1451606400,430.35,437.15,427.92,435.66,3788,16206.45,3788,16206.45,54.785324702037265,413715,390558.36126483826,390558.36126483826,413715,28.016540739637968,7.142857142857143,57.142857142857146,-4.956179042702958,8.36601918089201,13.322198223594969,54.785324702037265,46.151079136690676,38.34532374100724
1451692800,435.67,437.56,432.41,435.4,3193,16032.35,3193,16032.35,54.663223167918,410522,391072.96126483823,391072.96126483823,410522,26.354854705381864,0,50,-4.361486095336387,7.870340604424484,12.231826699760871,54.663223167918,49.51267056530209,44.08815637548445
1451779200,435.4,435.75,425.02,431.91,3839,7947.4,3839,7947.4,52.95707161894067,406683,392164.19612038345,392164.19612038345,406683,24.700688868994124,0,42.857142857142854,-4.094346644807603,7.113893393751368,11.208240038558971,52.95707161894067,43.82000000000006,46.49458323399765
1451865600,431.9,435.79,431.37,433.85,5848,7690.3,5848,7690.3,53.81992691898337,412531,392878.657658845,392878.657658845,412531,23.161418489019372,21.428571428571427,35.714285714285715,-3.690653513020141,6.594923147283794,10.285576660303935,53.81992691898337,47.700000000000045,47.010890188434104
1451952000,433.84,435.64,430,433.34,5111,6148.55,5111,6148.55,53.54189765383947,407420,393821.1115595542,393821.1115595542,407420,21.843107283961587,14.285714285714286,28.571428571428573,-3.3704749707983783,6.0724829468059625,9.44295791760434,53.54189765383947,46.67999999999994,46.06666666666673
1452038400,433.32,433.46,428.15,430.87,5441,6108.95,5441,6108.95,52.13712530421587,401979,393954.3187158631,393954.3187158631,401979,20.774185139013863,7.142857142857143,21.428571428571427,-3.236826670470357,5.396924579516394,8.633751249986751,52.13712530421587,41.74000000000001,45.37333333333337
1452124800,430.66,460.15,430.64,459.08,13878,6551.75,13878,6551.75,63.814344881490925,415857,406825.9168182013,406825.9168182013,415857,20.796220704397925,100,14.285714285714286,-1.2617946681658907,7.056507914779388,8.318302582945279,63.814344881490925,97.86640079760718,62.09546693253575
1452211200,459.07,464.4,447.53,454.44,8297,6620.25,8297,6620.25,61.1708133187056,407560,405325.866432902,405325.866432902,407560,21.058713722733618,100,7.142857142857143,-0.32968784726615397,7.9061927738625855,8.23588062112874,61.1708133187056,81.69117647058827,73.76585908939853
1452297600,454.41,456,447.66,450.38,4191,6414.4,4191,6414.4,58.87269268983662,403369,403868.5642746286,403868.5642746286,403369,21.30245723975962,92.85714285714286,0,-0.06236323473045502,8.15792657771567,8.220289812446126,58.87269268983662,74.21846267009933,84.59201331276496
1452384000,450.39,451.39,442.96,449.99,3898,6268.55,3898,6268.55,58.644773372486064,399471,406471.8549033356,406471.8549033356,399471,21.064739675023535,85.71428571428571,0,0.00862813528966555,8.231074981558208,8.222446846268543,58.644773372486064,68.94396551724144,74.95120155264306
1452470400,449.99,452.65,445.88,449.19,5545,6215.35,5545,6215.35,58.14748507996509,393926,406348.9967054036,406348.9967054036,393926,20.93097968039084,78.57142857142857,0,-0.07334475984697875,8.13076589645982,8.2041106563068,58.14748507996509,66.46825396825398,69.87689405186495
1452556800,449.26,449.44,431.83,434.01,6561,6166.35,6561,6166.35,49.55981979223602,387365,401412.41237831675,401412.41237831675,387365,19.51866666094962,71.42857142857143,14.285714285714286,-1.1644263765109404,6.748577685668124,7.9130040621790645,49.55981979223602,33.00264550264547,56.13828832938034
1452643200,434.01,437.5,425,432.76,8972,6274.45,8972,6274.45,48.91913288608104,378393,403580.0475783167,403580.0475783167,378393,18.57203167547408,64.28571428571429,7.142857142857143,-1.9391674686398641,5.489044726379234,7.428212195019098,48.91913288608104,30.246913580246876,43.239271017048814
1452729600,432.7,435.27,428,430.03,5640,6385.4,5640,6385.4,47.47560894507163,372753,401089.7587199948,401089.7587199948,372753,17.69301347467536,57.142857142857146,0,-2.5650496278120825,4.221900160253995,6.786949788066077,47.47560894507163,12.766497461928871,25.338685514940448
1452816000,430.04,430.29,357.3,357.53,28621,7142.25,28621,7142.25,25.747000196417318,344132,372649.1349359148,372649.1349359148,344132,20.012835558559587,50,100,-7.511532252279183,-2.6024655272829023,4.909066724996281,25.747000196417318,0.21475256769370815,14.409387869956527
1452902400,357.59,391,350.92,388.7,17976,7765.75,17976,7765.75,38.73043624834618,362108,388562.0211634597,388562.0211634597,362108,22.321918101012102,42.857142857142854,100,-8.273683242196036,-5.433037327748764,2.840645914447272,38.73043624834618,33.292210081071545,15.424486703564751
1452988800,388.7,391,372,378.46,8244,7833,8244,7833,36.47407924867518,353864,385923.9411634597,385923.9411634597,353864,24.46606617614658,35.714285714285715,92.85714285714286,-8.997055074251723,-8.40567292836738,0.5913821458843413,36.47407924867518,24.268593584772624,19.258518744512667
1453075200,378.47,386.1,370.1,384.89,8698,7951.05,8698,7951.05,38.881883022646974,362562,393306.3686634596,393306.3686634596,362562,26.507493653958342,28.571428571428573,85.71428571428571,-8.57385397041368,-10.125935317132758,-1.5520813467190786,38.881883022646974,29.93479027141345,29.165197979085917
1453161600,384.79,385.5,370,375.27,8109,8114.9,8109,8114.9,36.64407576872741,354453,390711.4886634596,390711.4886634596,354453,28.40591871406782,21.428571428571427,78.57142857142857,-8.458920021098912,-12.12573137309272,-3.666811351993807,36.64407576872741,21.45752555516388,25.220303137116698
1453248000,375.28,425.1,369,418.54,13841,8484.55,13841,8484.55,50.45621821526922,368294,401315.5203925149,401315.5203925149,368294,27.28732878178014,14.285714285714286,71.42857142857143,-5.148631150546652,-10.102600290177122,-4.95396913963047,50.45621821526922,59.58759252731761,36.99330278463169
1453334400,418.89,424.78,403.21,409.38,8716,8730.95,8716,8730.95,48.06721863977735,359578,397585.86438880605,397585.86438880605,359578,26.248638130370157,7.142857142857143,64.28571428571429,-3.3433118743688883,-9.13310898259158,-5.789797108222691,48.06721863977735,51.51568558336271,44.18693455528145
1453420800,409.02,413.99,373.86,382.9,13394,9241,13394,9241,41.89215709690177,346184,390226.3403419583,390226.3403419583,346184,26.435127877851667,0,57.142857142857146,-3.6736180567227468,-10.381819679126124,-6.708201622403378,41.89215709690177,30.433955081842377,47.17907773084094
1453507200,382.93,398.72,382.55,387.5,6285,9363.3,6285,9363.3,43.25591545609586,352469,387789.2995256317,387789.2995256317,352469,26.608296929084496,0,50,-3.333351796558806,-10.874891368101885,-7.541539571543079,43.25591545609586,35.957927848225694,39.30252283781031
1453593600,387.5,406.93,387.49,403.05,3534,9247.6,3534,9247.6,47.72249212502279,356003,389912.60816760705,389912.60816760705,356003,26.248819641333153,7.142857142857143,42.857142857142854,-1.8842202383773756,-9.896814869514799,-8.012594631137423,47.72249212502279,51.243487663422805,39.21179019783034
1453680000,403.04,403.04,386.41,391.4,6466,9315.35,6466,9315.35,44.87267880942264,349537,387326.9857983947,387326.9857983947,349537,25.95952041115656,0,35.714285714285715,-1.5475852013240754,-9.947076132792517,-8.399490931468442,44.87267880942264,41.088103938286615,42.76317314997842
1453766400,391.4,397,387.78,391.54,6956,9391.1,6956,9391.1,44.915249576540965,356493,386044.42614546634,386044.42614546634,356493,25.690885411706866,0,28.571428571428573,-1.1699508798517453,-9.861929531283124,-8.691978651431379,44.915249576540965,46.91614691614693,46.41591283928549
1453852800,391.7,397.18,390.7,394.79,6282,9011.3,6282,9011.3,45.95855519694931,362775,387692.48170102196,387692.48170102196,362775,25.42805610995958,0,21.428571428571427,-0.5852757271515703,-9.423573310370841,-8.838297583219271,45.95855519694931,52.00948429164199,46.67124504869188
1453939200,394.6,395,377.12,379.61,9044,9048.65,9044,9048.65,41.96096121172739,353731,381167.448143975,381167.448143975,353731,25.801062538222087,0,14.285714285714286,-1.0763066125078815,-10.183680848854124,-9.107374236346242,41.96096121172739,36.147158876149675,45.02426336131291
1454025600,379.63,385.05,363.25,378.68,12081,9443.15,12081,9443.15,41.721525812522515,341650,386188.26741003006,386188.26741003006,341650,26.685414776175627,0,7.142857142857143,-1.3039737223424623,-10.73734138927432,-9.433367666931858,41.721525812522515,37.42248584524129,41.859709671011025
1454112000,378.68,382.04,375,378.46,4130,9454.75,4130,9454.75,41.66096430678051,337520,386117.8696827573,386117.8696827573,337520,27.506598997132485,28.571428571428573,0,-1.306352272594097,-11.066308007674479,-9.759955735080382,41.66096430678051,24.591754244139004,32.72046632184337
1454198400,378.46,382.5,365,367.95,5464,9450.7,5464,9450.7,38.76594431031971,332056,382496.01825418585,382496.01825418585,332056,28.636735638159177,21.428571428571427,85.71428571428571,-1.8211059503359142,-12.036338173000274,-10.21523222266436,38.76594431031971,7.599029911075161,23.2044233334852
1454284800,367.89,379,366.26,371.33,7915,9518.4,7915,9518.4,40.20502648946759,339971,380880.71213173686,380880.71213173686,339971,29.686148233398253,14.285714285714286,78.57142857142857,-1.7394441739954072,-12.38953744015862,-10.650093266163212,40.20502648946759,13.063864187550495,15.084882780921602
1454371200,371.33,374.41,371.17,372.93,6817,9410.65,6817,9410.65,40.91292826819979,346788,381469.8355885269,381469.8355885269,346788,30.66060278612025,7.142857142857143,71.42857142857143,-1.3978724872485468,-12.397433875223896,-10.99956138797535,40.91292826819979,15.650767987065485,12.104554028563763
1454457600,372.93,373.01,365.63,368.87,7098,9483.55,7098,9483.55,39.63079878832498,339690,380604.22583242937,380604.22583242937,339690,31.785936536125043,0,64.28571428571429,-1.2693219992394447,-12.586213887024655,-11.31689188778521,39.63079878832498,9.133755891435083,12.616129355350404
1454544000,368.87,390.63,368.74,387.99,8851,8495.05,8851,8495.05,47.909733185719176,348541,387320.31125956506,387320.31125956506,348541,31.186562910333432,0,57.142857142857146,0.20115858819338506,-11.065443652543479,-11.266602240736864,47.909733185719176,48.75837603468665,24.514299971062457
1454630400,387.99,389.36,382.99,384.5,7414,7966.95,7414,7966.95,46.65210438952908,341127,383421.2688733798,383421.2688733798,341127,30.630001686384077,0,50,0.9922740821615257,-10.026259638034958,-11.018533720196483,46.65210438952908,48.649267399267394,35.51379977512976
1454716800,384.44,384.54,370.05,375.44,6245,7867,6245,7867,43.46254065505569,334882,381822.3075207228,381822.3075207228,334882,30.759411088865786,7.142857142857143,42.857142857142854,0.9583791347707891,-9.820559801732998,-10.778938936503787,43.46254065505569,27.907509157509146,41.771717530487784
1454803200,375.44,379.81,373.24,377.49,4131,7638.65,4131,7638.65,44.38900992731298,339013,383035.828068668,383035.828068668,339013,30.879576962598804,0,35.714285714285715,1.1159903601014847,-9.38395098637693,-10.499941346478415,44.38900992731298,35.787886403619005,37.44822098679857
1454889600,377.47,379.35,370.5,371.14,7065,7586.45,7065,7586.45,42.08830604275864,331948,376992.6585771426,376992.6585771426,331948,31.127168321988258,0,28.571428571428573,0.8467597596901264,-9.441491646865757,-10.288251406555883,42.08830604275864,23.253757736516313,28.983051099214872
1454976000,371.02,374.93,370.13,372.68,8344,7311.6,8344,7311.6,42.861776410894514,340292,377514.1585771426,377514.1585771426,340292,31.376217582030048,7.142857142857143,21.428571428571427,0.8256979159071616,-9.25612901167193,-10.081826927579092,42.861776410894514,27.792513999410566,28.944719379848678
1455062400,372.76,383.34,371.87,378.44,9717,7361.65,9717,7361.65,45.77875564927217,350009,378928.9266678139,378928.9266678139,350009,30.733993081045963,0,14.285714285714286,1.2287161463439737,-8.545931744649124,-9.774647890993098,45.77875564927217,47.84251968503936,32.96293047365547
1455148800,378.49,379.5,361.1,378.23,10317,7207.8,10317,7207.8,45.68717948558012,339692,387821.73210259655,387821.73210259655,339692,30.754879801621946,0,100,1.4926207242771419,-7.90887198564667,-9.401492709923811,45.68717948558012,58.008804605485984,44.547946096645354
1455235200,378.23,382.05,377.46,382.05,6137,7200.4,6137,7200.4,47.735300764161984,345829,393958.73210259655,393958.73210259655,345829,30.515918845521632,42.857142857142854,92.85714285714286,1.9092804464718682,-7.014892151833976,-8.924172598305844,47.735300764161984,70.9448018963766,58.9320420623007
1455321600,382.05,395.59,381.99,390.99,5916,7319.5,5916,7319.5,52.27147917547999,351745,395872.73210259655,395872.73210259655,351745,29.053314631848497,100,85.71428571428571,2.7222369449970643,-5.521376417059514,-8.243613362056578,52.27147917547999,86.6628008118296,71.87213577123079
1455408000,391,406.92,391,406.59,7526,7372.5,7526,7372.5,58.9643805904694,359271,403086.7245649081,403086.7245649081,359271,27.120956924262014,100,78.57142857142857,4.159789174758226,-3.0438768936087968,-7.203666068367022,58.9643805904694,99.2797904845045,85.62913106423696
1455494400,406.62,409.09,394.03,398.95,6524,7350.9,6524,7350.9,54.90376373160515,352747,400825.4177919997,400825.4177919997,352747,25.48111065213576,100,71.42857142857143,4.4208635370109,-1.6775866471033964,-6.098450184114297,54.90376373160515,78.8705980412586,88.27106311253095
1455580800,398.94,407.5,390.2,407.42,5498,7311.7,5498,7311.7,58.329877535122975,358245,406272.5692370864,406272.5692370864,358245,23.66320685961636,92.85714285714286,64.28571428571429,4.948884936451746,0.08765598645038608,-4.86122895000136,58.329877535122975,96.52010835590755,91.55683229389028
1455667200,407.41,420.13,405.69,415.2,8699,7294.45,8699,7294.45,61.242586820632575,366944,409031.6703451196,409031.6703451196,366944,22.864573794320293,100,57.142857142857146,5.5612301150451895,2.0903086938051274,-3.470921421240062,61.242586820632575,91.64831441639842,89.01300693785491
1455753600,415.18,423.2,415.01,421.19,6480,7014.4,6480,7014.4,63.36578790681459,373424,412331.0110044603,412331.0110044603,373424,22.321191877972016,100,50,6.067418872087044,4.113352168868744,-1.9540667032183008,63.36578790681459,96.7632850241546,94.97723593215358
1455840000,421.18,422,416,420.72,5759,7095.85,5759,7095.85,63.073815930106306,367665,415632.837671127,415632.837671127,367665,21.816622955648615,92.85714285714286,42.857142857142854,6.054444606426385,5.613989054814681,-0.44045555161170435,63.073815930106306,96.00644122383258,94.80601355479526
1455926400,420.72,444.03,420.09,437.46,9327,7289,9327,7289,68.6198618496356,376992,419840.50684405933,419840.50684405933,376992,22.611858108654182,100,35.714285714285715,6.801251838795496,8.061109246882666,1.2598574080871696,68.6198618496356,92.07765585433498,94.94912736744078
1456012800,438.04,448.7,426.01,438.56,7064,7246.45,7064,7246.45,68.94987729523694,384056,420590.8038912167,420590.8038912167,384056,23.568176111268617,100,28.571428571428573,6.971516834754165,9.974253451529876,3.002736616775711,68.94987729523694,88.42465753424659,92.16958487080478
1456099200,438.56,439,430.95,437.55,5110,7161.1,5110,7161.1,68.24024501178157,378946,423859.93432599935,423859.93432599935,378946,24.456185685124872,92.85714285714286,21.428571428571427,6.620945986257739,11.278919099597886,4.657973113340146,68.24024501178157,87.27168949771692,89.25800096209956
1456185600,437.45,440.9,414.16,419.97,9146,7263.5,9146,7263.5,57.20427454190908,369800,418688.3741165753,418688.3741165753,369800,23.73182271320658,85.71428571428571,14.285714285714286,4.889753659251916,10.770165187405041,5.880411528153125,57.20427454190908,67.20319634703199,80.96651445966523
1456272000,420.32,425.6,410,423.94,7194,7180.65,7194,7180.65,58.82374530961299,376994,424351.3433473445,424351.3433473445,376994,22.725979505959668,78.57142857142857,7.142857142857143,3.748092416626224,10.565527048935905,6.8174346323096815,58.82374530961299,71.7351598173516,75.40334855403357
1456358400,423.87,426.44,418.6,423.54,6003,7110.1,6003,7110.1,58.58319829781153,370991,425913.3484493853,425913.3484493853,370991,21.848748431707502,71.42857142857143,0,2.748359753757372,10.252884324506397,7.504524570749025,58.58319829781153,64.68276249298151,67.87370621912176
1456444800,423.51,430.85,419.53,430.85,6703,7133,6703,7133,61.66815508530234,377694,432616.3484493853,432616.3484493853,377694,21.337229593018602,64.28571428571429,0,2.3757629334534176,10.474228237565796,8.098465304112379,61.66815508530234,73.24239244491086,69.88677158508138
1456531200,430.84,434.97,430.14,433.12,5451,7199,5451,7199,62.599777388705235,383145,433891.634163671,433891.634163671,383145,21.139491070785603,57.142857142857146,0,2.088718980702563,10.709364029990581,8.620645049288019,62.599777388705235,73.3675213675214,70.43089210180466
1456617600,433.09,436.07,423,433.73,5105,7101,5105,7101,62.86099298510911,388250,437168.67700988374,437168.67700988374,388250,20.293033654578753,50,14.285714285714286,1.7596472912215368,10.82020416331494,9.060556872093404,62.86099298510911,74.41025641025645,73.67339007422963
1456704000,433.73,442,431.13,436.44,7553,7061.45,7553,7061.45,64.06188605116083,395803,436994.96495836583,436994.96495836583,395803,19.9309304032735,42.857142857142854,7.142857142857143,1.551490414198721,10.999919889841806,9.448429475643085,64.06188605116083,79.04273504273506,75.6068376068377
1456790400,436.41,437.78,427.5,433.08,7556,6953.4,7556,6953.4,61.41050944852338,388247,437641.7820789884,437641.7820789884,388247,19.2544112553916,35.714285714285715,0,1.0391231467106046,10.747333409031341,9.708210262320737,61.41050944852338,63.68286445012786,72.37861863437318
1456876800,433.03,435.36,418.36,420.39,7396,6807.35,7396,6807.35,52.56234022640418,380851,432012.12090251775,432012.12090251775,380851,17.92735881703777,28.571428571428573,0,-0.23484533644123395,9.414653591769195,9.649498928210429,52.56234022640418,26.847545219638217,56.524381570833775
1456963200,420.44,422.8,408.63,418.8,11800,7090.5,11800,7090.5,51.5599351263671,369051,437150.1590111981,437150.1590111981,369051,17.430085465999934,21.428571428571427,100,-1.2104758454815805,8.136404121358453,9.346879966840033,51.5599351263671,25.380583978038477,38.63699788260158
1457049600,418.76,422.21,405.5,407.35,8928,7241.1,8928,7241.1,44.916835416345755,360123,430199.0351332807,430199.0351332807,360123,17.188668132655284,14.285714285714286,100,-2.5744529746152107,6.1288137485710195,8.70326672318623,44.916835416345755,4.282407407407461,18.836845535028115
1457136000,407.38,408.83,381.09,396.08,14888,7609.2,14888,7609.2,39.51957047468449,345235,431401.23844979116,431401.23844979116,345235,18.348256381442592,7.142857142857143,100,-4.092981428149914,3.5870399379988385,7.680021366148752,39.51957047468449,22.171276438396696,17.278089274614274
1457222400,396.13,409.27,385.01,403.24,7636,7664.8,7636,7664.8,44.11409588197623,352871,435241.2714258835,435241.2714258835,352871,19.38350042036829,0,92.85714285714286,-4.443287610119559,2.1259118534993036,6.569199463618863,44.11409588197623,36.365128878673495,20.939604241492614
1457308800,403.24,418.74,395,412.21,9871,7883.45,9871,7883.45,49.30946891854999,362742,439681.97403750947,439681.97403750947,362742,19.47457609823071,50,85.71428571428571,-3.917373952828113,1.672482022583722,5.589855975411835,49.30946891854999,51.09177474963059,36.54272668890032
1457395200,412.21,416.33,407.4,411.18,7462,7821.6,7462,7821.6,48.74905345869753,355280,438537.1879232878,438537.1879232878,355280,19.559146370531526,42.857142857142854,78.57142857142857,-3.499080088968161,1.2160058642016338,4.715085953169795,48.74905345869753,49.4007552126088,45.61921961363769
1457481600,411.18,414,408.75,412.8,5350,7765.1,5350,7765.1,49.71702638061912,360630,441441.47363757354,441441.47363757354,360630,19.637675909096572,35.714285714285715,71.42857142857143,-2.993075961799904,0.9737410009199152,3.966816962719819,49.71702638061912,52.0604170087014,50.850982323646996
1457568000,412.64,416.52,410.71,415.98,7871,7870.7,7871,7870.7,51.647556290873894,368501,447849.3617614979,447849.3617614979,368501,19.45566752416214,28.571428571428573,64.28571428571429,-2.3522449321889902,1.0265107974835814,3.3787557296725717,51.647556290873894,57.28123460843873,52.91413560991637
1457654400,415.98,421,414.97,419.39,7020,7755.35,7020,7755.35,53.70034965590161,375521,451120.7050450799,451120.7050450799,375521,18.83841241144173,21.428571428571427,57.142857142857146,-1.640461128964735,1.3281793184666526,2.9686404474313877,53.70034965590161,62.8796585125595,57.4071033765666
1457740800,419.48,421.3,406.52,410.58,6856,7744.95,6856,7744.95,48.027246173898604,368665,448031.33021422743,448031.33021422743,368665,18.890679094329048,14.285714285714286,50,-1.6976312940629361,0.8466013298527173,2.5442326239156534,48.027246173898604,48.415695288130024,56.19219613637615
1457827200,410.56,416.38,410.01,412.52,4612,7720.05,4612,7720.05,49.2974799092481,373277,447053.9047825163,447053.9047825163,373277,18.93921244272441,7.142857142857143,42.857142857142854,-1.5438608237136058,0.6144065942736461,2.158267417987252,49.2974799092481,51.60072237727795,54.298692059322555
1457913600,412.51,415.84,411.61,415.02,6607,7593.1,6607,7593.1,50.960794144755845,379884,451099.32558629883,451099.32558629883,379884,18.98427912337725,0,35.714285714285715,-1.2266810889682387,0.6249160567769536,1.8515971457451923,50.960794144755845,59.85182571882168,53.289414461409955
1458000000,415.02,416.94,412.48,415.41,7323,7599.55,7323,7599.55,51.22958253937815,387207,453398.0251378684,453398.0251378684,387207,18.891937090202255,0,28.571428571428573,-0.9555660951944478,0.6571395267521325,1.6127056219465803,51.22958253937815,63.23935876174687,58.230635619282225
1458086400,415.41,416.39,413,416.07,6256,7612.2,6256,7612.2,51.711942039163105,393463,458472.9513915558,458472.9513915558,393463,18.806190916539762,0,21.428571428571427,-0.7081271869563286,0.7275466382511695,1.435673825207498,51.711942039163105,83.8647806281467,68.98532170290515
1458172800,416.06,419.75,415.7,418.41,6078,7580.95,6078,7580.95,53.469106302837424,399541,460528.9662063707,460528.9662063707,399541,18.28333511034293,0,14.285714285714286,-0.37967150658103876,0.9610844419811997,1.3407559485622385,53.469106302837424,90.75875486381334,79.28763141790238
1458259200,418.42,418.66,399.21,409.65,8556,7736.2,8556,7736.2,46.62846698499856,390985,461158.01916266885,461158.01916266885,390985,19.175697187282253,0,7.142857142857143,-0.7251649927113406,0.4342997076730626,1.1594647003844032,46.62846698499856,71.02710768465549,81.88354772553858
1458345600,409.66,411,404.72,410.2,4779,7719.9,4779,7719.9,47.08619346628096,395764,464719.43954483443,464719.43954483443,395764,20.00431911586877,50,0,-0.8791701725518795,0.06050198469455381,0.9396721572464333,47.08619346628096,69.41306144943506,77.06630799930137
1458432000,410.09,415.34,409.36,411.27,4667,7575.6,4667,7575.6,48.02017216138006,400431,463033.7004143996,463033.7004143996,400431,20.191119901827857,42.857142857142854,0,-0.8698919938998634,-0.14769283512839593,0.7221991587714675,48.02017216138006,61.863117870722334,67.43442900160436
1458518400,411.25,412.13,406.89,412,5971,7496.35,5971,7496.35,48.68564540903295,406402,468708.4294220332,468708.4294220332,406402,20.56809289877726,35.714285714285715,0,-0.7784726928082993,-0.25089170723890675,0.5275809855693926,48.68564540903295,57.899502037120875,63.05856045242615
1458604800,411.98,417.79,411,416.66,6092,7431.15,6092,7431.15,52.83660551492687,412494,472772.75342792424,472772.75342792424,412494,20.171632141954603,28.571428571428573,71.42857142857143,-0.3877835627969083,0.042851532073257204,0.4306350948701655,52.83660551492687,78.99502037120878,66.25254675968405
1458691200,416.66,418.99,413.95,417.53,5446,7113.45,5446,7113.45,53.591395650849584,417940,475063.53120570193,475063.53120570193,417940,19.650158892520604,21.428571428571427,64.28571428571429,-0.07098358030583246,0.3419056194878749,0.41288919979370736,53.591395650849584,82.93345405160692,73.27599215331226
1458777600,417.53,417.72,410,412.95,5022,6918.15,5022,6918.15,49.13350119289254,412918,473879.58820052055,473879.58820052055,412918,19.552128827449927,14.285714285714286,57.142857142857146,-0.16474754444734335,0.20695476923452816,0.3717023136818715,49.13350119289254,62.20009053870525,74.70952165384038
1458864000,412.86,416.87,411,416.41,4572,6402.35,4572,6402.35,52.35770643629568,417490,477735.0226127863,477735.0226127863,417490,19.4611009098843,7.142857142857143,50,0.0025397356179674424,0.3748769832043308,0.3723372475863634,52.35770643629568,77.86328655500236,74.33227704843824
1458950400,416.42,417.77,414.37,416.97,3578,6199.45,3578,6199.45,52.87831138358268,421068,479629.25790690404,479629.25790690404,421068,19.240274278685458,0,42.857142857142854,0.1396023888564702,0.5468402336569511,0.4072378448004809,52.87831138358268,86.46543330087648,75.50960346486143
1459036800,416.96,426.5,416.35,425.3,4600,5935.9,4600,5935.9,59.89807527920362,425668,483141.57317784,483141.57317784,425668,17.895527606268406,100,35.714285714285715,0.7460808465606047,1.3398389030012368,0.5937580564406321,59.89807527920362,95.60278490289488,86.64383491959131
1459123200,425.29,425.36,419.63,423,5683,5846.95,5683,5846.95,57.35734693305323,419985,484143.2887101262,484143.2887101262,419985,16.646834267595427,92.85714285714286,28.571428571428573,0.9349051979497537,1.7623895538778243,0.8274843559280706,57.35734693305323,87.17478930010994,89.7476691679605
1459209600,422.92,424.62,407.75,416.39,7319,5945.4,7319,5945.4,50.70121340609739,412666,484321.16600710305,484321.16600710305,412666,16.758095645382447,85.71428571428571,21.428571428571427,0.5748685931758535,1.5460700973978874,0.9712015042220339,50.70121340609739,62.95346280688895,81.91034566996466
1459296000,416.4,416.41,407.56,412.79,5812,5842.45,5812,5842.45,47.470193055552365,406854,485378.49030088837,485378.49030088837,406854,16.880008602524192,78.57142857142857,14.285714285714286,0.08047121432061011,1.0717905221227966,0.9913193078021865,47.470193055552365,49.76181751557358,66.63002320752422
1459382400,412.97,417.6,412.74,416.03,5181,5750.5,5181,5750.5,50.5259976424597,412035,487212.0952391599,487212.0952391599,412035,16.81534567821143,71.42857142857143,7.142857142857143,-0.0358943568379233,0.9464513617547823,0.9823457185927056,50.5259976424597,61.63429827775735,58.11652620007336
1459468800,416.03,417.68,414.12,417.68,5309,5673.15,5309,5673.15,52.05560933448442,417344,492521.0952391599,492521.0952391599,417344,16.74271406527244,64.28571428571429,0,-0.01060511407024034,0.9690893260049052,0.9796944400751455,52.05560933448442,59.50413223140494,56.96674934157869
1459555200,417.68,420.5,417.04,419.95,3896,5637.35,3896,5637.35,54.1555984945321,421240,495178.48252239684,495178.48252239684,421240,16.22417717507679,57.142857142857146,0,0.14173604062930645,1.1568644908617784,1.015128450232472,54.1555984945321,66.59867414584392,62.57903488500212
1459641600,419.95,420.8,418.33,420.16,3199,5466.95,3199,5466.95,54.35478167334382,424439,496719.70114587864,496719.70114587864,424439,15.694120430715333,50,7.142857142857143,0.23393746469081012,1.3075502810959847,1.0736128164051746,54.35478167334382,67.66955634880178,64.59078757535026
1459728000,420.08,421,417.58,419.47,5278,5364.7,5278,5364.7,53.531795308897465,419161,497275.2800932472,497275.2800932472,419161,15.309031996291234,42.857142857142854,0,0.22564203144501027,1.3556653557114373,1.130023324266427,53.531795308897465,62.88278775079211,65.71700608181266
1459814400,419.48,423.43,418.01,422.36,5695,5336.65,5695,5336.65,56.50245603862122,424856,500721.70075745386,500721.70075745386,424856,14.523957396373314,35.714285714285715,57.142857142857146,0.38274492793978365,1.6084544841911566,1.225709556251373,56.50245603862122,78.14149947201696,69.56461452387033
1459900800,422.4,423,420.61,421.46,5180,5291.75,5180,5291.75,55.316466276081286,419676,499226.2195859056,499226.2195859056,419676,13.794959553592387,28.571428571428573,50,0.3925394008023555,1.7163838072543172,1.3238444064519617,55.316466276081286,73.38965153115089,71.47131291798671
1459987200,421.36,422.74,419.41,421.99,4970,5112.45,4970,5112.45,55.90346362017993,424646,501957.48084716685,501957.48084716685,424646,13.324013394995665,21.428571428571427,42.857142857142854,0.39985494768087015,1.8236630910530494,1.4238081433721792,55.90346362017993,76.18796198521652,75.90637099612819
1460073600,421.99,424.65,415.71,419.48,6408,5193.9,6408,5193.9,52.3931518851921,418238,500953.990914281,500953.990914281,418238,13.489707408878656,14.285714285714286,35.714285714285715,0.21031621040779536,1.6867034063819233,1.476387195974128,52.3931518851921,62.935586061246134,70.83773319253791
1460160000,419.48,419.79,415.51,419.46,3448,5132.95,3448,5132.95,52.3649363360588,414790,503870.2899797015,503870.2899797015,414790,13.675306705423978,7.142857142857143,28.571428571428573,0.06575558505539791,1.5585816772933754,1.4928260922379775,52.3649363360588,62.8299894403378,67.31784582893353
1460246400,419.46,423.99,419.46,423.4,2925,4980.65,2925,4980.65,57.24930130542526,417715,506033.3694499002,506033.3694499002,417715,12.964960136850994,0,21.428571428571427,0.20953255417871253,1.754741784961368,1.5452092307826555,57.24930130542526,88.98876404494362,71.58477984884257
1460332800,423.29,424,420.15,423.94,5059,4929,5059,4929,57.88665906196393,422774,510934.6863330171,510934.6863330171,422774,12.303330786235026,0,14.285714285714286,0.3090392911352222,1.9315083447016832,1.622469053566461,57.88665906196393,95.84552369806916,82.55475906111691
1460419200,423.95,429.77,423.14,427.8,6961,5004.75,6961,5004.75,62.22230440446072,429735,513758.9834672554,513758.9834672554,429735,12.23397827228374,100,7.142857142857143,0.5867522774660878,2.355909400399071,1.769157122932983,62.22230440446072,91.1301215668619,91.98813643662494
1460505600,427.8,429.44,423.59,425.58,5862,5046.75,5862,5046.75,58.49251184625975,423873,511885.1475698195,511885.1475698195,423873,12.169579509328972,92.85714285714286,0,0.5722545916940915,2.4844753625505973,1.9122207708565058,58.49251184625975,75.39635936582499,87.45733487691872
1460592000,425.58,428,424.52,426.32,4703,5053.3,4703,5053.3,59.36685606376328,428576,512047.31998361263,512047.31998361263,428576,12.10978065801383,85.71428571428571,0,0.5629609112845526,2.6159219099621964,2.052960998677644,59.36685606376328,77.95527156549525,81.4939174993941
1460678400,426.35,431.1,425.72,430.93,4138,5081.3,4138,5081.3,64.39817795846395,432714,515923.8106899323,515923.8106899323,432714,12.615766725856536,100,0,0.8031074478842504,3.0568453085329566,2.253737860648706,64.39817795846395,98.90955740859515,84.08706277997184
1460764800,430.82,434.89,429.89,433.39,4079,5055.25,4079,5055.25,66.76322314816235,436793,517555.4106899323,517555.4106899323,436793,13.688940790159645,100,50,1.0479709802397728,3.5637015859484222,2.5157306057086495,66.76322314816235,92.26006191950464,89.70829696453173
1460851200,433.69,434.93,429.15,431,3219,4932.05,3219,4932.05,62.424426866896255,433574,516397.0162262645,516397.0162262645,433574,14.489380350290896,100,42.857142857142854,0.9710506758053765,3.72954395046537,2.7584932746599935,62.424426866896255,79.76313079299689,90.31091670703226
1460937600,431.08,434.46,428.44,430.97,5234,4827.8,5234,4827.8,62.36963536484313,428340,515562.3584189556,515562.3584189556,428340,15.03871095152369,92.85714285714286,35.714285714285715,0.8448712516193639,3.8145823391841986,2.9697110875648347,62.36963536484313,79.60865087538632,83.87728119596265
1461024000,430.9,438.2,429.22,437.06,6180,4846.2,6180,4846.2,68.42783672356597,434520,520173.2715592674,520173.2715592674,434520,16.159036369951306,100,28.571428571428573,1.0830701694799907,4.323548799414823,3.2404786299348323,68.42783672356597,94.97576024680481,84.78251397172937
1461110400,437.06,444.07,436.17,442.96,7107,4942.5,7107,4942.5,72.96828094583718,441627,525283.1145972421,525283.1145972421,441627,17.973835091100394,100,21.428571428571427,1.5225736999504154,5.1436957548728515,3.621122054922436,72.96828094583718,96.11344537815123,90.23261883344749
1461196800,442.87,453.8,441.99,452.25,7675,5060.8,7675,5060.8,78.26789443156483,449302,530943.5083313657,530943.5083313657,449302,20.570492695427554,100,14.285714285714286,2.2780831872685,6.468726039008061,4.190642851739561,78.26789443156483,95.95194567772262,95.68038376755959
1461283200,452.25,452.95,445.07,448.41,6797,5205.85,6797,5205.85,71.9856257107955,442505,529908.4321892337,529908.4321892337,442505,22.981674756588482,92.85714285714286,7.142857142857143,2.348935892221954,7.126812717017003,4.777876824795049,71.9856257107955,85.92321755027427,92.66286953538274
1461369600,448.57,455.84,447.03,455.69,4589,5275.35,4589,5275.35,75.93012226637026,447094,534341.1665819692,534341.1665819692,447094,25.448874036743312,100,0,2.6912434957363036,8.141931194465428,5.450687698729125,75.93012226637026,99.58768554150639,93.82094958983447
1461456000,455.68,465,454.55,464.46,6127,5317.8,6127,5317.8,79.64782296843572,453221,539834.9455293376,539834.9455293376,453221,28.32474032646451,100,0,3.2747038712795318,9.54406753782854,6.269363666549007,79.64782296843572,98.79598662207353,94.76896323795144
1461542400,464.47,472.38,454.65,466.17,9466,5506.35,9466,5506.35,80.28716153466945,462687,542669.9404531955,542669.9404531955,462687,31.346142795019016,100,0,3.520711756336542,10.670253361969685,7.149541605633143,80.28716153466945,87.38830219333879,95.2573247856396
1461628800,466.17,472.11,464.01,470.59,7439,5619.3,7439,5619.3,81.87232139390005,470126,547317.0194655411,547317.0194655411,470126,34.151730801533915,92.85714285714286,0,3.707236272740877,11.78358694655924,8.076350673818363,81.87232139390005,96.33121541299442,94.17183474280229
1461715200,470.3,470.79,440.94,445.31,11253,5933.45,11253,5933.45,54.7533136811766,458873,539358.8677067471,539358.8677067471,458873,32.590165615905384,85.71428571428571,0,1.9428656859440174,10.504932781248385,8.562067095304368,54.7533136811766,43.43919765984123,75.71957175539153
1461801600,445.3,451.88,434.79,451.68,7613,5993.7,7613,5993.7,58.48487108637057,466486,546793.6816330198,546793.6816330198,466486,30.42325973682784,78.57142857142857,0,1.0636039411529996,9.891572021745617,8.827968080592617,58.48487108637057,55.636519502786115,65.13564419187396
1461888000,451.67,459.44,448.5,458.82,5927,6117.65,5927,6117.65,62.243571544443384,472413,552048.882729912,552048.882729912,472413,29.14984024651509,71.42857142857143,0,0.8319190573093085,9.867866902229252,9.035947844919944,62.243571544443384,69.13973600364132,56.071817722089605
1461974400,458.8,459.33,450.13,454.02,4661,6204.45,4661,6204.45,58.414614038439595,467752,551329.4675125206,551329.4675125206,467752,27.967379291224674,64.28571428571429,14.285714285714286,0.2543890909165629,9.353934208565647,9.099545117649084,58.414614038439595,58.21574874829309,60.99733475157356
1462060800,454.02,457.07,451.55,456.98,2878,6095.4,2878,6095.4,60.04681130224335,470630,554113.6196864337,554113.6196864337,470630,26.86937983274072,57.142857142857146,7.142857142857143,-0.014989530894670366,9.080808204030745,9.095797734925416,60.04681130224335,64.9522075557579,64.10256410256416
1462147200,456.98,457.63,440.02,446.42,7666,6130.65,7666,6130.65,52.17851801957298,462964,552019.7264439579,552019.7264439579,462964,25.399477921852565,50,0,-0.9398842379652503,7.920942437468852,8.860826675434103,52.17851801957298,39.85171455050973,54.339890284853624
1462233600,446.53,453.29,443.61,452.23,5864,6130.75,5864,6130.75,55.623894410699855,468828,556599.461981148,556599.461981148,468828,24.03456900459928,42.857142857142854,0,-1.1803218759662677,7.385424330476269,8.565746206442537,55.623894410699855,46.395317903697816,50.39974666998853
1462320000,452.21,453.23,446.76,448.68,4845,6137.85,4845,6137.85,53.10624008427126,463983,554630.0106673922,554630.0106673922,463983,22.76715358143551,35.714285714285715,57.142857142857146,-1.5737940859465063,6.598503599009405,8.172297684955911,53.10624008427126,36.95131683958498,41.06611643126423
1462406400,448.59,451.56,447,449.98,5285,6195.2,5285,6195.2,53.92860719625585,469268,556252.5983866905,556252.5983866905,469268,21.590267831354872,28.571428571428573,50,-1.7294562728584228,6.010477343882883,7.739933616741306,53.92860719625585,40.40968342644322,41.25210605657539
1462492800,449.99,463.73,448.84,462.31,6151,6298.8,6151,6298.8,60.92745822972082,475419,561230.4056398806,561230.4056398806,475419,21.058999400942906,21.428571428571427,42.857142857142854,-1.0200530628116962,6.464867288226685,7.484920351038381,60.92745822972082,73.21096036179836,50.19065354260891
1462579200,462.31,464,459.55,461.91,3414,6308.55,3414,6308.55,60.605802558598185,472005,561437.5472129143,561437.5472129143,472005,20.593727951111696,14.285714285714286,35.714285714285715,-0.6157056626900941,6.715288272675764,7.330993935365858,60.605802558598185,72.14684756584204,61.92249711802793
1462665600,461.91,465,457.5,462.79,3226,6208.15,3226,6208.15,61.0924554852008,475231,562762.357879581,562762.357879581,475231,19.866706511742496,7.142857142857143,28.571428571428573,-0.340667965746869,6.905158978182271,7.24582694392914,61.0924554852008,74.48789571694604,73.2819012148622
1462752000,462.6,465.9,459.41,464.16,5841,6191.2,5841,6191.2,61.881934361256,481072,565471.3578795812,565471.3578795812,481072,19.2988626401623,0,21.428571428571427,-0.12904990968794028,7.084514556819215,7.213564466507155,61.881934361256,78.6977491961415,75.11083082630991
1462838400,464.15,465,448.2,452.78,6784,6175.05,6784,6175.05,52.3750628083527,474288,562386.2531176764,562386.2531176764,474288,18.536489602692793,0,14.285714285714286,-0.7816565069004504,6.236493832881592,7.018150339782043,52.3750628083527,49.972222222222086,67.71928904510327
1462924800,452.77,458.65,452.5,454.37,5720,6077.3,5720,6077.3,53.45108893607037,480008,560144.757182717,560144.757182717,480008,17.828571782185396,0,7.142857142857143,-1.1122350047554423,5.62785658383774,6.740091588593183,53.45108893607037,62.937962070073965,63.86931116281257
1463011200,454.56,456.57,449.27,456.48,6068,6040.85,6068,6040.85,54.90710619205811,486076,566063.1352649088,566063.1352649088,486076,17.548415888100624,78.57142857142857,0,-1.1879228637984243,5.255188008845153,6.443110872643577,54.90710619205811,63.601236476043425,58.83714025611321
1463097600,456.48,458.03,453.84,457.98,5350,6078.9,5350,6078.9,55.9616900681347,491426,571285.4503007084,571285.4503007084,491426,17.065644440506407,71.42857142857143,21.428571428571427,-1.1361037842771262,5.022981142297169,6.1590849265742955,55.9616900681347,69.39721792890278,65.31213882500678
1463184000,457.97,459.83,456,458.9,3232,5934.15,3232,5934.15,56.6316170975648,494658,572947.8628333454,572947.8628333454,494658,16.339938693688044,64.28571428571429,14.285714285714286,-1.0415071023388132,4.857201048650779,5.8987081509895924,56.6316170975648,72.95208655332303,68.65018031942314
1463270400,458.9,463.62,458.49,461.47,3201,5620.9,3201,5620.9,58.529486187132626,497859,573465.7634181408,573465.7634181408,497859,15.241832862935906,57.142857142857146,7.142857142857143,-0.8173842116656038,4.8769778864075874,5.694362098073191,58.529486187132626,82.88253477588891,75.07727975270497
1463356800,461.48,461.59,451.48,455.66,6000,5548.95,6000,5548.95,52.89404998508878,491859,572427.187750485,572427.187750485,491859,15.006601178071897,50,0,-1.0567547338054109,4.373418680816428,5.430173414621839,52.89404998508878,54.06011664423522,69.96491265781577
1463443200,455.64,457.49,452.2,454.19,5996,5286.1,5996,5286.1,51.54185671235262,485863,570942.355992451,570942.355992451,485863,14.788171756412464,42.857142857142854,0,-1.2947085306587764,3.811787751298368,5.106496281957145,51.54185671235262,38.81922675026129,58.587292723461864
1463529600,454.19,457.88,453.6,455.56,5470,5178.95,5470,5178.95,52.75408422591176,491333,570482.262534507,570482.262534507,491333,14.519887498229739,35.714285714285715,0,-1.3351073524419315,3.4376120914047306,4.772719443846662,52.75408422591176,45.291005291005355,46.056782895167345
1463616000,455.56,456.41,435,438.38,8366,5300.9,8366,5300.9,39.43242938572398,482967,564757.7459534701,564757.7459534701,482967,16.1517362198169,28.571428571428573,100,-2.430339454230177,1.7347951260589412,4.165134580289118,39.43242938572398,10.938511326860835,31.68291445604255
1463702400,437.91,445.85,435.5,445.65,7150,5425.35,7150,5425.35,45.683182416538195,490117,571631.4174510546,571631.4174510546,490117,17.66702431843355,21.428571428571427,92.85714285714286,-2.5634256282828902,0.9608525449355056,3.524278173218396,45.683182416538195,34.46601941747568,30.23184534511401
1463788800,445.52,446.99,441.88,446.28,3913,5477.1,3913,5477.1,46.20133126443021,494030,574457.0475880408,574457.0475880408,494030,18.871893856177397,14.285714285714286,85.71428571428571,-2.504387499751491,0.39379379852903185,2.898181298280523,46.20133126443021,36.50485436893198,27.303128371089553
1463875200,446.27,446.45,440.89,442.48,3720,5279.8,3720,5279.8,43.505503453105725,490310,572864.6734873215,572864.6734873215,490310,20.07911114475502,7.142857142857143,78.57142857142857,-2.605028701694985,-0.35810457883820845,2.2469241228567767,43.505503453105725,24.2071197411004,31.72599784250274
1463961600,442.45,446.3,440.79,445.67,5624,5267.8,5624,5267.8,46.33630857778663,495934,577202.6045218043,577202.6045218043,495934,21.209514663012552,0,71.42857142857143,-2.3484551789300734,-0.6886448508058152,1.6598103281242582,46.33630857778663,35.56666666666672,32.092880258899754
1464048000,445.56,448.5,440.5,446.99,6488,5349.95,6488,5349.95,47.50840022439858,502422,581241.3845218043,581241.3845218043,502422,21.80901116867573,0,64.28571428571429,-1.9954228220908188,-0.8344681994892653,1.1609546226015535,47.50840022439858,41.89378057302588,33.88918899359772
1464134400,446.98,452.42,446.86,451.49,6119,5391.65,6119,5391.65,51.405083713827594,508541,585313.380924682,585313.380924682,508541,21.60924417242212,28.571428571428573,57.142857142857146,-1.3929503330914164,-0.580233293762717,0.8127170393286993,51.405083713827594,57.617051013277454,45.02583275099007
1464220800,451.45,454.99,449,454.97,5825,5375.35,5825,5375.35,54.234488333401494,514366,591099.4827610761,591099.4827610761,514366,20.96005760457686,21.428571428571427,50,-0.7276354066444325,-0.09682721897684132,0.6308081876675912,54.234488333401494,69.77638015373873,56.42907058001407
1464307200,454.97,476.75,454.35,471.27,9857,5697.5,9857,5697.5,64.62420071096894,524223,596133.5934753618,596133.5934753618,524223,21.238205112896505,100,42.857142857142854,0.7619919127289383,1.583298078578764,0.8213061658498257,64.62420071096894,86.87425149700594,71.42256088800742
1464393600,471.21,539.49,470.13,523.25,12049,6138.65,12049,6138.65,80.1220242844646,536272,602540.2705226514,602540.2705226514,536272,24.221717502778613,100,35.714285714285715,4.965471056139808,7.028144986024586,2.062673929884778,80.1220242844646,84.45784285577567,80.3694915021735
1464480000,523.35,549.99,492.91,525.22,9815,6337.35,9815,6337.35,80.4712083821049,546087,603836.78593961,603836.78593961,546087,27.213643591185406,100,28.571428571428573,7.446747943723281,11.371108859538879,3.924360915815598,80.4712083821049,78.45899643447258,83.26369692908479
1464566400,525.22,541,519,532.55,5921,6294.2,5921,6294.2,81.75542554946334,552008,605209.3813941554,605209.3813941554,552008,29.991860673277426,92.85714285714286,21.428571428571427,9.043599220570115,15.228859941528242,6.1852607209581265,81.75542554946334,84.83346377945905,82.58343435656916
1464652800,532.56,544.9,520.01,531.34,8494,6432.9,8494,6432.9,80.8107163691016,543514,604448.3681358187,604448.3681358187,543514,32.656011217973,85.71428571428571,14.285714285714286,9.436785035216143,17.981242014978307,8.544456979762163,80.8107163691016,83.78119836507526,82.35788619300236
1464739200,531.25,541.5,524.39,534.84,5680,6413.5,5680,6413.5,81.47744603364879,549194,605706.5329517159,605706.5329517159,549194,35.129865295190314,78.57142857142857,7.142857142857143,9.333998061537804,20.211954556684418,10.877956495146615,81.47744603364879,86.82494129924343,85.14653448125931
1464825600,534.85,541.2,531.86,537.87,6295,6460.75,6295,6460.75,82.05861996982827,555489,607512.8070416516,607512.8070416516,555489,37.42701550974925,71.42857142857143,0,8.874464844084802,21.971037550252618,13.096572706167816,82.05861996982827,89.41392261332867,86.67335409254918
1464912000,538.06,578,535.96,571.25,10168,6807.55,10168,6807.55,86.92556611814356,565657,614415.6310188161,614415.6310188161,565657,40.240381212134075,100,0,10.132058879325408,25.761646305324575,15.629587425999167,86.92556611814356,95.0909090909091,90.44325766782713
1464998400,571.09,594.64,564.29,576.31,6896,6992.3,6896,6992.3,87.48000504862216,572553,612981.8992230995,612981.8992230995,572553,43.05845060393411,100,21.428571428571427,10.569580601861418,28.84156317832594,18.271982576464524,87.48000504862216,88.10821331257296,90.87101500560362
1465084800,576.31,585,570.22,575.17,4924,6938.5,4924,6938.5,86.5890966549054,567629,611356.1130255351,611356.1130255351,567629,45.67522932489129,92.85714285714286,14.285714285714286,10.050401546701892,30.834984509841888,20.784582963139997,86.5890966549054,87.36862592448422,90.18924944265548
1465171200,575.17,588.15,575,586.77,6746,6976,6746,6976,87.93548945303688,574375,616686.2225312386,616686.2225312386,574375,48.143590445341154,85.71428571428571,7.142857142857143,9.74892734135583,32.97074213983478,23.221814798478952,87.93548945303688,94.89425197872065,90.123697071926
1465257600,586.75,590.95,497.01,579.71,9557,7180.35,9557,7180.35,82.50633216774683,564818,623956.2163570848,623956.2163570848,564818,45.10083369659407,78.57142857142857,0,8.386652709981973,33.70513068595642,25.318477975974446,82.50633216774683,89.89714440384358,90.72000743568287
1465344000,579.72,583.99,572.96,583.21,5605,7042.3,5605,7042.3,83.06456157247206,570423,628768.4874359607,628768.4874359607,570423,42.27541671561464,71.42857142857143,0,7.085701261865076,34.17560455330579,27.089903291440713,83.06456157247206,92.15188135127715,92.31442591128052
1465430400,583.19,583.48,574,577.46,4951,6932.35,4951,6932.35,78.62561060181883,565472,627431.5085330071,627431.5085330071,565472,39.65181523327659,64.28571428571429,0,5.284920884837611,33.69605439748773,28.411133512650117,78.62561060181883,87.75393827072496,89.9343213419486
1465516800,577.47,581,573.5,580.31,5619,7017.65,5619,7017.65,79.21840640089484,571091,632016.612533007,632016.612533007,571091,37.190681107308706,57.142857142857146,0,3.802043806582464,33.1636882708782,29.361644464295733,79.21840640089484,88.49088426632396,89.46556796277541
1465603200,580.31,610,580.31,609.5,5492,7106.25,5492,7106.25,84.0864322527528,576583,637323.6344259003,637323.6344259003,576583,36.06470305186828,100,0,4.268448862015536,34.69720554181515,30.428756679799616,84.0864322527528,99.57297805107183,91.93926686270697
1465689600,609.5,687.71,605,677.86,17948,7722.45,17948,7722.45,89.99638184614712,594531,650996.7510986122,650996.7510986122,594531,36.875072731480266,100,0,8.422185704633335,40.95648881059128,32.534303105957946,89.99638184614712,94.8348190875721,94.29956046832268
1465776000,677.45,720,663.55,706.01,15493,8172.7,15493,8172.7,91.41094581144175,610024,658810.4926397991,658810.4926397991,610024,38.1117684549387,100,57.142857142857146,12.08402079999398,47.639329105950424,35.555308305956444,91.41094581144175,93.7261760617068,96.04465773345028
1465862400,706.02,706.45,650.02,684.95,12420,8487.75,12420,8487.75,82.06181466175616,597604,661766.3778072633,661766.3778072633,597604,38.65472854879841,92.85714285714286,50,12.077572799083406,50.6522743048107,38.5747015057273,82.06181466175616,84.28180635902959,90.94760050276955
1465948800,684.99,699.3,673,698.78,7863,8589.65,7863,8589.65,83.27177570881724,605467,669318.4454878716,669318.4454878716,605467,39.158905778811,85.71428571428571,42.857142857142854,11.971325093893185,53.538857873093775,41.56753277920059,83.27177570881724,90.48387820081618,89.4972868738509
1466035200,698.76,777.68,698.76,769.76,16798,8936.7,16798,8936.7,87.8146398589522,622265,682744.9259744403,682744.9259744403,622265,40.672892842017866,100,35.714285714285715,15.427988963514451,60.852518983593654,45.4245300200792,87.8146398589522,97.17818078170095,90.64795511384894
1466121600,769.71,778.5,709.01,752.26,13990,9033.75,13990,9033.75,81.90860287465559,608275,686169.4460492712,686169.4460492712,608275,42.08731685716022,100,28.571428571428573,15.254862349052246,64.49310795639451,49.238245607342265,81.90860287465559,90.67817684464812,92.78007860905512
1466208000,752,785.15,734.8,758.99,9577,9021.85,9577,9021.85,82.39886858803861,617852,685794.7352250408,685794.7352250408,617852,43.473482597639226,100,21.428571428571427,14.32726204036917,67.14732315780373,52.820061117434555,82.39886858803861,90.92108003054071,92.92581255229663
1466294400,759,771.92,744.77,768.76,5407,8996.15,5407,8996.15,83.11425995819141,623259,689943.0891845252,689943.0891845252,623259,44.76063649951259,92.85714285714286,14.285714285714286,13.136749547409437,69.24099805169635,56.104248504286915,83.11425995819141,94.31179287846186,91.97034991788361
1466380800,768.94,768.94,702.42,703.12,9715,9057.2,9715,9057.2,64.22664771370106,613544,680432.554007135,680432.554007135,613544,44.11099769294332,85.71428571428571,7.142857142857143,7.001426084910349,64.85603111042485,57.8546050255145,64.22664771370106,71.53120011105713,85.58802434001996
1466467200,706.47,718.26,628.6,667.66,26035,10074.95,26035,10074.95,56.726918990550566,587509,677081.6294030752,677081.6294030752,587509,41.27025227524826,78.57142857142857,0,-0.0015258746161634917,57.8526976822443,57.85422355686046,56.726918990550566,44.62981290352983,70.15760196434967
1466553600,667.88,679.99,568.11,604.5,15570,10538.7,15570,10538.7,46.346100990892204,571939,671640.2010870223,671640.2010870223,571939,39.273881638575574,71.42857142857143,100,-8.948930063746772,46.66806097717699,55.616991040923764,46.346100990892204,16.766494655363065,44.30916922331673
1466640000,606.13,637.89,544.13,631.1,20481,11054.35,20481,11054.35,50.45797967058177,592420,689154.7763856571,689154.7763856571,592420,37.837373172453454,64.28571428571429,100,-12.89737160154376,39.49527653899406,52.39264814053782,50.45797967058177,36.084142394822024,32.493483317905024
1466726400,631.1,700,631.01,669.98,19061,11662.6,19061,11662.6,55.791063118195304,611481,691627.5398296346,691627.5398296346,611481,35.156606599578225,57.142857142857146,92.85714285714286,-12.692499735152495,36.527023471597204,49.2195232067497,55.791063118195304,52.21558376898184,35.02207360638903
1466812800,669.98,699,650,673.71,7662,11799.5,7662,11799.5,56.277334327460345,619143,691380.4794214714,691380.4794214714,619143,32.66732335333693,50,85.71428571428571,-12.109413320704405,34.082756555869196,46.1921698765736,56.277334327460345,53.76317318064893,47.354299781484315
1466899200,673.71,675.19,625.01,638.56,5637,11744.05,5637,11744.05,50.62609035871887,613506,688787.7739611286,688787.7739611286,613506,30.845495107763483,42.857142857142854,78.57142857142857,-13.773466674908072,28.975336532938513,42.748803207846585,50.62609035871887,39.17932121815615,48.38602605592902
1466985600,638.56,659.98,630,657.87,6575,11594.95,6575,11594.95,53.39485493724097,620081,694437.2736275728,694437.2736275728,620081,29.153797451159562,35.714285714285715,71.42857142857143,-13.251848787077897,26.183992223999212,39.43584101107711,53.39485493724097,47.19110447265788,46.71119962382104
1467072000,657.86,663.53,638,648.43,5658,11597.6,5658,11597.6,51.86367509108514,614423,693402.3006545998,693402.3006545998,614423,27.497192563044422,28.571428571428573,64.28571428571429,-13.192192770640709,22.945600047776225,36.13779281841693,51.86367509108514,43.27441706082482,43.21494758387967
1467158400,648.43,648.43,630.02,639.42,6456,11672.85,6456,11672.85,50.37872636852585,607967,693539.065456338,693539.065456338,607967,26.136255303579592,21.428571428571427,57.142857142857146,-13.367703501190547,19.428163441928746,32.79586694311929,50.37872636852585,39.53613807982739,43.33388653777008
1467244800,639.41,675,635.14,673.49,7734,11778.6,7734,11778.6,55.56018929937699,615701,700687.0975687314,700687.0975687314,615701,24.336107672769806,14.285714285714286,50,-10.901678972749018,19.168768227183023,30.07044719993204,55.56018929937699,53.67189444859349,45.49414986308195
1467331200,673.5,688.99,667,678.19,6811,11844.55,6811,11844.55,56.239051492362485,622512,700807.8929302593,700807.8929302593,622512,22.99531655540055,7.142857142857143,42.857142857142854,-8.758742054470012,19.122019631844523,27.880761686314536,56.239051492362485,55.62194008795953,49.60999087212685
1467417600,678.09,705.21,676.92,704.95,4926,11193.45,4926,11193.45,59.98691995194918,627438,705643.3478613304,705643.3478613304,627438,22.122279468706694,0,35.714285714285715,-5.5028658766141625,21.00217934054683,26.505045217160994,59.98691995194918,70.6001141402169,59.96464955892336
1467504000,705.25,705.25,651,663.55,6438,10740.7,6438,10740.7,52.49618739024772,621000,702184.0354189341,702184.0354189341,621000,20.62577262424202,0,28.571428571428573,-6.057369162759219,18.93333376371197,24.99070292647119,52.49618739024772,53.12041279302519,59.78082234040059
1467590400,664.09,683.69,653.16,681.98,4274,10333.4,4274,10333.4,55.1793999163639,625274,705979.2578231266,705979.2578231266,625274,19.23615912581054,0,21.428571428571427,-5.139059703277262,18.566878297374615,23.705938000651877,55.1793999163639,79.16499167288808,67.62850620204344
1467676800,681.98,682.37,662.51,669.87,4999,10190.2,4999,10190.2,53.058664865211334,620275,704685.4582259464,704685.4582259464,620275,17.94580373440988,0,14.285714285714286,-5.283037543664108,17.102141071071742,22.38517861473585,53.058664865211334,78.04121151936445,70.10887199509263
1467763200,669.75,680.79,665,678.79,5623,9631.45,5623,9631.45,54.447426633344186,625898,708884.0123741415,708884.0123741415,625898,16.747616585252125,78.57142857142857,7.142857142857143,-4.731162346082396,16.471225682132854,21.20238802821525,54.447426633344186,83.57745779543195,80.26122032922821
1467849600,678.79,683.44,611.94,641.97,12262,9545.05,12262,9545.05,48.11904158212891,613636,706922.0923741414,706922.0923741414,613636,16.860083953674014,71.42857142857143,0,-6.680306822020846,12.85200450068919,19.532311322710036,48.11904158212891,32.18304576144035,64.60057169207896
1467936000,641.97,667.33,638.04,667.33,11038,9618.1,11038,9618.1,52.236784619121025,624674,717960.0923741414,717960.0923741414,624674,16.9645179386372,64.28571428571429,92.85714285714286,-6.111456495564841,11.892990703253986,18.004447198818827,52.236784619121025,59.36126888865075,58.37392414850773
1468022400,667.07,667.3,608,657.61,9590,9827.25,9590,9827.25,50.5797572162071,615084,724415.9574668902,724415.9574668902,615084,17.716689440780176,57.142857142857146,100,-6.2189902838768525,10.230709343972762,16.449699627849615,50.5797572162071,51.01285347043704,47.51905604017609
1468108800,657.6,657.61,641,652.44,3689,9525.95,3689,9525.95,49.677108997741534,611395,725808.4938907312,725808.4938907312,611395,18.415134407055795,50,92.85714285714286,-6.440286725513445,8.399341220957808,14.839627946471253,49.677108997741534,45.69665809768643,52.02359348559145
1468195200,652.43,664.27,648.11,650.97,4782,8463.3,4782,8463.3,49.40712201787913,606613,722719.1325045926,722719.1325045926,606613,18.808102038573068,42.857142857142854,85.71428571428571,-6.470482596850491,6.75152470040814,13.222007297258632,49.40712201787913,44.185089974293085,46.964867180805555
1468281600,651.25,675.5,648.6,666.56,10656,8217.6,10656,8217.6,52.36401188537332,617269,726292.2596421391,726292.2596421391,617269,18.743780232981365,35.714285714285715,78.57142857142857,-5.275840532073644,6.627206632166576,11.90304716424022,52.36401188537332,60.215938303341844,50.032562125107155
1468368000,666.25,671.45,654.86,655.34,21870,8287.05,21870,8287.05,50.09482605953079,595399,705687.793096027,705687.793096027,595399,18.68405284207478,28.571428571428573,71.42857142857143,-5.075045748268815,5.559239978904202,10.634285727173017,50.09482605953079,48.67866323907459,51.02656383890321
1468454400,655.3,663.99,640,661.65,4548,7561.4,4548,7561.4,51.37112542642272,599947,709348.5634169941,709348.5634169941,599947,19.03474313051848,21.428571428571427,64.28571428571429,-4.377410477960321,5.162522629722616,9.539933107682938,51.37112542642272,55.167095115681214,54.68723221936592
1468540800,661.4,669.98,660.68,667.48,4682,7412.4,4682,7412.4,52.577860682044836,604629,711513.3591159189,711513.3591159189,604629,19.10268781268473,14.285714285714286,57.142857142857146,-3.4255918844625715,5.257943252104724,8.683535136567295,52.577860682044836,61.16195372750644,55.002570694087446
1468627200,667.48,669.99,662.01,666.32,2848,7272.95,2848,7272.95,52.299766661162316,601781,711741.7701434878,711741.7701434878,601781,19.165329546899365,7.142857142857143,50,-2.8026298650704646,5.1802478052292145,7.982877670299679,52.299766661162316,59.96915167095121,58.76606683804633
1468713600,666.3,680.99,665.95,680,3888,7138.6,3888,7138.6,55.302292677407806,605669,715117.919079658,715117.919079658,605669,18.72191764460534,0,42.857142857142854,-1.4650035823394374,6.151623192375382,7.6166267747148195,55.302292677407806,95.12485136741967,72.08531892195914
1468800000,680,684.94,670,675.5,4494,7080.4,4494,7080.4,54.096027611775455,601175,713932.7544210234,713932.7544210234,601175,18.131604803696053,100,35.714285714285715,-0.9064262534596903,6.483593957890207,7.390020211349897,54.096027611775455,87.73069924616578,80.94156742817893
1468886400,675.51,676.87,666.17,673.98,3752,6945.2,3752,6945.2,53.670185635012245,597423,715657.9731126123,715657.9731126123,597423,17.72793250544842,92.85714285714286,28.571428571428573,-0.6731806957934099,6.548544341608135,7.221725037401545,53.670185635012245,85.75513387054845,89.53689482804468
1468972800,673.98,674.99,664.6,666.92,3554,6736.2,3554,6736.2,51.63694207184706,593869,713691.1299942292,713691.1299942292,593869,17.414816983507304,85.71428571428571,21.428571428571427,-1.0080894497263708,5.961613225243582,6.969702674969953,51.63694207184706,76.57915258643088,83.35499523438175
1469059200,667.15,668.4,661.19,667.28,3921,6591.7,3921,6591.7,51.737345835710975,597790,716393.9552369476,716393.9552369476,597790,17.263787854952245,78.57142857142857,14.285714285714286,-1.2057251436016152,5.462546245467934,6.668271389069549,51.737345835710975,77.04704964907711,79.79377870201886
1469145600,667.27,669.94,647.59,654.67,7351,6712.95,7351,6712.95,47.97989904095446,590439,713700.2330892966,713700.2330892966,590439,17.65826731568056,71.42857142857143,7.142857142857143,-2.1319273614229957,4.003362187290804,6.1352895487138,47.97989904095446,60.657655315830425,71.42795251711284
1469232000,654.7,662.35,653.92,657.5,4359,6609,4359,6609,48.87724310173525,594798,713043.5391391187,713043.5391391187,594798,18.024569672071138,64.28571428571429,0,-2.476024087993949,3.040259438721364,5.516283526715313,48.87724310173525,38.940809968847304,58.88183831125165
1469318400,657.68,666.37,655.01,661,3373,6563.95,3373,6563.95,50.0254056375507,598171,713227.6289278511,713227.6289278511,598171,18.106784880489112,57.142857142857146,28.571428571428573,-2.3888290564042567,2.5302472062099923,4.919076262614249,50.0254056375507,46.72897196261677,48.77581241576487
1469404800,660.92,664.13,653.77,657.79,4059,6516.95,4059,6516.95,48.93979785395846,594112,712318.6636768858,712318.6636768858,594112,18.23897971518745,50,21.428571428571427,-2.45865151353466,1.8457618706959238,4.304413384230584,48.93979785395846,39.58611481975955,41.751965583741246
1469491200,657.99,658.99,645,654.06,6442,6557.9,6442,6557.9,47.645910573193575,587670,714220.4120685941,714220.4120685941,587670,18.75410850267035,42.857142857142854,14.285714285714286,-2.6508107031335713,0.9909000053136197,3.641710708447191,47.645910573193575,31.286159323542343,39.2004153686396
1469577600,654.06,658.99,646.56,657.35,5134,6201.5,5134,6201.5,48.92849129995398,592804,717999.663878731,717999.663878731,592804,19.232442376761615,35.714285714285715,7.142857142857143,-2.455533150544169,0.5722942702669798,3.027827420811149,48.92849129995398,38.607031597685804,36.493101913662606
1469664000,657,659.97,654.1,657.4,3777,5838.45,3777,5838.45,48.94896034019299,596581,718469.3759741313,718469.3759741313,596581,19.59761339077802,28.571428571428573,0,-2.2288270998516047,0.24179354599664293,2.4706206458482476,48.94896034019299,31.046569854782074,33.646586925336784
1469750400,657.4,659,651,657,4183,5568.1,4183,5568.1,48.78052240475,592398,720560.8759741313,720560.8759741313,592398,20.09425889621209,21.428571428571427,78.57142857142857,-2.0179445821225084,-0.051810081804887886,1.9661345003176205,48.78052240475,30.045067601402064,33.23288968462336
1469836800,657.18,658.98,652.95,655.87,2917,5529.5,2917,5529.5,48.27513654796302,589481,720468.9638679953,720468.9638679953,589481,20.555429722686583,14.285714285714286,71.42857142857143,-1.8700223490443235,-0.37139343598778396,1.4986289130565396,48.27513654796302,27.21582373560338,29.43582039726255
1469923200,655.95,657,621.37,626.97,6252,5603,6252,5603,37.557915272453215,583229,716182.2290939285,716182.2290939285,583229,22.327845353439958,7.142857142857143,100,-3.537271095546183,-2.9229599563761894,0.6143111391699937,37.557915272453215,8.80918672329718,22.023359353434248
1470009600,626.97,629.34,599,605.2,7940,5467.2,7940,5467.2,31.826153748429476,575289,711487.318085359,711487.318085359,575289,24.61165184952223,0,100,-5.791751812690639,-6.625378626693305,-0.833626814002666,31.826153748429476,7.9619879285990045,14.66233279583323
1470096000,604.87,613.38,483,537.47,14824,5114.9,14824,5114.9,21.05849481068094,560465,709049.6239604931,709049.6239604931,560465,28.290228826523382,0,100,-11.21597380304244,-14.853594067805716,-3.637620264763276,21.05849481068094,28.371269336944646,15.047481329613651
1470182400,538.8,576,519.3,573.36,20208,5897.9,20208,5897.9,33.83328495328904,580673,727375.82078589,727375.82078589,580673,31.706050305167317,0,92.85714285714286,-11.7042317376697,-18.2679099368504,-6.563678199180702,33.83328495328904,48.33636460896544,28.223207291503073
1470268800,573.35,599.95,562.11,587.5,9507,6139.15,9507,6139.15,38.08445709850882,590180,730626.893196038,730626.893196038,590180,33.5877233068601,7.142857142857143,85.71428571428571,-10.434485616323478,-19.60678521958505,-9.172299603261571,38.08445709850882,55.90028886273669,44.20264093621563
1470355200,587.5,592.87,570.39,583,5451,6269.3,5451,6269.3,37.263906647667184,584729,731291.2944415896,731291.2944415896,584729,35.334991094146254,0,78.57142857142857,-9.295197750890628,-20.791296791874856,-11.496099040984229,37.263906647667184,54.53454763592736,52.92373370254321
1470441600,583,591.72,574.5,591.71,3836,6266.7,3836,6266.7,39.96031847793339,588565,735122.8391570367,735122.8391570367,588565,36.957454039483395,7.142857142857143,71.42857142857143,-7.433184970426877,-20.787580254017826,-13.354395283590948,39.96031847793339,59.28450673501665,56.573114411226946
1470528000,591.7,598.65,587.2,595.14,3223,6203.15,3223,6203.15,41.035106747358405,591788,736369.8164496132,736369.8164496132,591788,38.06054447206414,0,64.28571428571429,-5.535807534343279,-20.274154701520047,-14.738347167176768,41.035106747358405,61.911334400706664,58.57679625721693
1470614400,595.14,595.99,590,591.48,3809,6206,3809,6206,40.20798676156044,587979,734443.0601891791,734443.0601891791,587979,39.0848427308891,0,57.142857142857146,-4.155577889029008,-19.93281952846303,-15.77724163943402,40.20798676156044,61.298525173758264,60.831455436493904
1470700800,591.58,594.04,585.38,586.45,4782,6267.4,4782,6267.4,39.04324294503175,583197,730842.7553392947,730842.7553392947,583197,40.127403230947436,14.285714285714286,50,-3.249799175714351,-19.83949060907696,-16.58969143336261,39.04324294503175,58.456235520144666,60.555365031536574
1470787200,586.75,601.09,583.29,594.94,9400,6541.35,9400,6541.35,42.0923882959805,592597,733747.2497213172,733747.2497213172,592597,40.630934341701206,7.142857142857143,42.857142857142854,-1.8186577673122244,-18.863013642502892,-17.044355875190668,42.0923882959805,63.25365881222808,61.00280650204371
1470873600,594.94,599.99,585.6,587.91,5017,6424.65,5017,6424.65,40.2950085492286,587580,730340.9891236799,730340.9891236799,587580,41.098498944543984,0,35.714285714285715,-1.1195570505953967,-18.443802188434915,-17.32424513783952,40.2950085492286,59.607954545454525,60.4392829592758
1470960000,587.9,590.09,583.62,587.74,3818,6397.6,3818,6397.6,40.25024926533644,583762,731385.4806229072,731385.4806229072,583762,41.583969617409885,0,28.571428571428573,-0.47559240145082526,-17.91873563965305,-17.443143238202225,40.25024926533644,59.51812705989316,60.79324680585862
1471046400,587.68,589.5,586,586.45,2771,6367.5,2771,6367.5,39.88817181246732,580991,729327.0234800501,729327.0234800501,580991,42.0347638136425,0,21.428571428571427,0.029664525502834493,-17.40606258132368,-17.435727106826516,39.88817181246732,59.45402298850577,59.52670153128452
1471132800,586.45,586.49,565.19,574.99,4108,6369.95,4108,6369.95,36.72733607524612,576883,728999.1549354492,728999.1549354492,576883,42.9825052467453,0,14.285714285714286,-0.22759751608568024,-17.720224001933616,-17.492626485847936,36.72733607524612,62.8604619379527,60.61087066211726
1471219200,574.97,574.97,561.56,567.79,4369,6266.3,4369,6266.3,34.85838627917754,572514,728689.6433769108,728689.6433769108,572514,43.945602213652194,0,7.142857142857143,-0.6769235847432462,-18.338780966776994,-17.661857382033748,34.85838627917754,65.03298051848441,62.44915514831433
1471305600,567.85,581.99,566.09,579.02,4638,6241.5,4638,6241.5,39.98793022855833,577152,731594.956584458,731594.956584458,577152,44.26553745147486,0,0,-0.0453748597371586,-17.718575956705195,-17.673201096968036,39.98793022855833,73.01626115662057,66.9699012043526
1471392000,579.02,581.99,569.67,574.45,4455,6275.4,4455,6275.4,38.65399199131893,572697,730596.9208701723,730596.9208701723,572697,44.562620172310204,50,0,0.22232274832779808,-17.39529766155829,-17.617620409886086,38.65399199131893,32.60814571211756,56.88579579574088
1471478400,574.45,576.99,573,574.09,3915,6262,3915,6262,38.54491206413485,568782,728820.9434265634,728820.9434265634,568782,44.838482698800156,42.857142857142854,78.57142857142857,0.5160980204550683,-16.97249788431725,-17.488595904772318,38.54491206413485,31.697444978497494,45.77395061574524
1471564800,574.05,576.99,572.68,573.67,3974,6314.85,3974,6314.85,38.40873250132477,564808,726672.5861179787,726672.5861179787,564808,45.10538835452542,35.714285714285715,71.42857142857143,0.8058127303893521,-16.48132999178563,-17.28714272217498,38.40873250132477,30.634960789273936,31.646850493296366
1471651200,573.68,583.92,572.38,581.87,3534,6178.95,3534,6178.95,42.667601053227834,568342,728951.0055287239,728951.0055287239,568342,44.677152467013926,28.571428571428573,64.28571428571429,1.6260666866780547,-15.254559363827411,-16.880626050505466,42.667601053227834,51.37869972173037,37.90370182983397
1471737600,581.72,583.99,579.34,581.29,2368,5900.35,2368,5900.35,42.444042822985224,565974,728569.0700448529,728569.0700448529,565974,44.27262376928759,21.428571428571427,57.142857142857146,2.171828073316984,-14.165840958859235,-16.33766903217622,42.444042822985224,49.91145965089799,43.97504005396746
1471824000,581.34,586.99,579.22,585.2,4446,5381.45,4446,5381.45,44.55316924384906,570420,730966.5912803742,730966.5912803742,570420,43.58945081744336,14.285714285714286,50,2.798524396435184,-12.83951353663224,-15.638037933067423,44.55316924384906,59.80268150771578,53.69761362678141
1471910400,585.19,586.77,577.47,582.39,5026,4622.35,5026,4622.35,43.324430809790066,565394,731258.4235384387,731258.4235384387,565394,43.04408493431325,7.142857142857143,42.857142857142854,3.007863608906371,-11.87820842193446,-14.88607203084083,43.324430809790066,52.69415633695926,54.13609916519104
1471996800,582.39,582.68,575.29,578.47,3802,4337.1,3802,4337.1,41.6007896925146,561592,730728.5101419571,730728.5101419571,561592,42.65187965693211,0,35.714285714285715,2.866944426110031,-11.302391498203292,-14.169335924313323,41.6007896925146,44.00208170699988,52.16630651722502
1472083200,578.68,579,573.12,575.58,4057,4267.4,4057,4267.4,40.326975480129924,557535,730066.1427950184,730066.1427950184,557535,42.40394818179703,0,28.571428571428573,2.573075130674585,-10.952992010970092,-13.526067141644678,40.326975480129924,49.141254819488445,48.61249762114923
1472169600,575.57,579.86,574.85,579.29,3244,4237.8,3244,4237.8,42.750444030665975,560779,732571.9871063955,732571.9871063955,560779,42.064351783542584,0,21.428571428571427,2.614076804330093,-10.25847113623206,-12.872547940562153,42.750444030665975,63.45740873299923,52.20024841982922
1472256000,579.29,579.45,568.95,570.84,3047,4229,3047,4229,38.87763032760267,557732,730621.9071063956,730621.9071063956,557732,42.08380331448636,0,14.285714285714286,2.0808389365646427,-10.27149926985635,-12.352338206420992,38.87763032760267,36.49233189146702,49.69699848131827
1472342400,570.83,575.41,569.65,575.41,2521,4164.6,2521,4164.6,41.94100196783161,560253,733142.9071063956,733142.9071063956,560253,42.10186545036272,57.142857142857146,7.142857142857143,2.0417953893263956,-9.800093969762997,-11.841889359089393,41.94100196783161,54.46323240267396,51.47099100904677
1472428800,575.41,577.73,571.24,573.21,4494,4150.2,4494,4150.2,40.87884361123277,555759,731377.1598028517,731377.1598028517,555759,41.78164689939663,50,0,1.8778507465716192,-9.49457592587487,-11.372426672446489,40.87884361123277,34.06698564593307,41.67418331335806
1472515200,573.21,576.83,572.53,574.95,4127,3886.55,4127,3886.55,42.12719332097498,559886,731895.4342214564,731895.4342214564,559886,41.48430110207096,42.857142857142854,0,1.891376359702253,-9.008206222818671,-10.899582582520924,42.12719332097498,33.25942350332601,40.59654718397772
1472601600,574.95,575.15,569.21,572.89,4396,3855.5,4396,3855.5,41.02280612098186,555490,732946.329844352,732946.329844352,555490,41.440530614221856,35.714285714285715,71.42857142857143,1.7686099042443093,-8.688820202215538,-10.457430106459848,41.02280612098186,21.84035476718375,29.722254638814317
1472688000,572.89,573.31,568.12,573.02,5183,3923.75,5183,3923.75,41.12769530135053,560673,737550.1121179551,737550.1121179551,560673,41.476340478398996,28.571428571428573,100,1.7025835051042417,-8.329200725079545,-10.031784230183787,41.12769530135053,25.96714361420231,27.022307294904063
1472774400,572.94,577.97,570,576.21,4796,4025,4796,4025,43.770370696503086,565469,740227.928931004,740227.928931004,565469,40.72959894200739,21.428571428571427,92.85714285714286,1.8669834060497,-7.698054972621662,-9.565038378671362,43.770370696503086,42.87228404875479,30.22659414338032
1472860800,576.41,600.99,574.67,600.91,4618,4050.5,4618,4050.5,59.08499496107489,570087,744817.8559826757,744817.8559826757,570087,38.32238893279455,100,85.71428571428571,3.535654649207654,-5.145470067161796,-8.68112471636945,59.08499496107489,99.7566169759658,56.198681546307675
1472947200,600.93,617.13,597.52,611.92,4527,4058.4,4527,4058.4,63.81580095633695,574614,746939.3822447868,746939.3822447868,574614,37.28143467060483,100,78.57142857142857,5.177977233372141,-2.2086531746542732,-7.386630408026415,63.81580095633695,89.36951642521926,77.33280581664665
1473033600,611.94,611.99,601.63,605.69,2949,3973.95,2949,3973.95,59.61534891335537,571665,746301.7606231653,746301.7606231653,571665,36.3148342842858,92.85714285714286,71.42857142857143,5.6056735431380345,-0.3795384791038714,-5.985212022241906,59.61534891335537,76.65782493368712,88.59465277829077
1473120000,605.93,612.99,605.47,612.99,4099,3956.15,4099,3956.15,62.71242215588391,575764,750400.7606231653,750400.7606231653,575764,35.486763781305655,85.71428571428571,64.28571428571429,6.10032161557651,1.640189997228731,-4.460131618347779,62.71242215588391,91.55274433789025,85.86002856559891
1473206400,612.99,618.53,609.21,615.21,4626,3991.7,4626,3991.7,63.625990648021514,580390,751730.983799131,751730.983799131,580390,35.09817254908647,100,57.142857142857146,6.272905887338872,3.3810007408258116,-2.8919051465130607,63.625990648021514,93.41400515770694,87.20819147642813
1473292800,615.22,631.3,613.43,627.97,5172,4051.6,5172,4051.6,68.4159051199236,585562,754975.4225232496,754975.4225232496,585562,35.483639769988535,100,50,6.892920610784762,5.724245616967892,-1.1686749938168701,68.4159051199236,94.72934472934483,93.23203140831406
1473379200,627.97,628.69,618.25,622.07,4448,4097.3,4448,4097.3,64.2057642712747,581114,753782.4723316787,753782.4723316787,581114,35.84157361796902,92.85714285714286,42.857142857142854,6.554325909644881,7.024232393239231,0.46990648359435006,64.2057642712747,85.39094650205776,91.17809879636987
1473465600,622.07,626.54,620.59,623.74,2758,4116.8,2758,4116.8,64.86483301109212,583872,753944.7076257964,753944.7076257964,583872,36.173940762522335,85.71428571428571,35.714285714285715,6.100804166807978,8.095911692104323,1.9951075252963448,64.86483301109212,88.0341880341881,89.3848264218636
1473552000,623.58,630.11,591.8,607.94,4219,4105.45,4219,4105.45,54.61821748471783,579653,753280.636365029,753280.636365029,579653,33.66864022197959,78.57142857142857,28.571428571428573,4.47022318625433,7.582886508114257,3.112663321859927,54.61821748471783,63.02627413738538,78.81713622454377
1473638400,607.94,609.45,603,606.74,3919,4050.1,3919,4050.1,53.921523385283734,575734,753906.4611712305,753906.4611712305,575734,31.342289720047027,71.42857142857143,21.428571428571427,3.1089113771977392,6.998802543357101,3.889891166159362,53.921523385283734,61.12693890471674,70.72913369209677
1473724800,606.86,609.99,605.16,608.63,3846,4052.3,3846,4052.3,54.89734835500355,579580,755586.5978171933,755586.5978171933,579580,29.135897656175796,64.28571428571429,14.285714285714286,2.1778452260165153,6.612197698680006,4.434352472663491,54.89734835500355,64.11839189616971,62.75720164609064
1473811200,608.39,611.99,608,608.43,3684,4033.65,3684,4033.65,54.76517886946912,575896,752696.6429299751,752696.6429299751,575896,27.20099328446992,57.142857142857146,7.142857142857143,1.426914076925084,6.217995068819846,4.791080991894762,54.76517886946912,63.80183602405821,63.01572227498158
1473897600,608.47,609.49,603.33,605.44,3912,4067.05,3912,4067.05,52.72158692573662,571984,751464.6169559491,751464.6169559491,571984,25.541139439571232,50,0,0.6469496011713183,5.59976799335891,4.9528183921875915,52.72158692573662,57.8140293637848,61.91141909467094
1473984000,605.43,608.1,603.15,607.93,4125,4120.95,4125,4120.95,54.252565993713176,576109,755306.2836226156,755306.2836226156,576109,24.016576100371243,42.857142857142854,0,0.2379208940989228,5.250219509811245,5.012298615712322,54.252565993713176,58.73212078403672,60.1159953906266
1474070400,607.95,608.99,604,607.92,2878,4138.8,2878,4138.8,54.244968835646425,573231,756950.0311176055,756950.0311176055,573231,22.505498800962144,35.714285714285715,0,-0.077256928059521,4.915727455637921,4.992984383697442,54.244968835646425,40.81012658227849,52.4520922433667
1474156800,607.92,611.93,607.22,611.4,3012,4064.7,3012,4064.7,56.52646509311097,576243,759284.171244994,759284.171244994,576243,21.014028560019497,28.571428571428573,50,-0.09418896061329907,4.875248182930818,4.969437143544117,56.52646509311097,49.62025316455702,49.72083351029077
1474243200,611.4,612.46,607.4,608.6,3243,4020.5,3243,4020.5,54.185331944823,573000,757579.3530631759,757579.3530631759,573000,19.68809223663976,21.428571428571427,42.857142857142854,-0.32385895817994115,4.564613445819191,4.888472403999132,54.185331944823,42.53164556962042,44.32067510548534
1474329600,608.6,609.92,605.6,605.6,4523,4026.85,4523,4026.85,51.71400411891537,568477,753056.3530631759,753056.3530631759,568477,18.324771138323584,14.285714285714286,35.714285714285715,-0.6868547027011243,4.029904025622727,4.7167587283238515,51.71400411891537,34.936708860759666,42.3628691983124
1474416000,605.6,605.6,592.63,597,4835,4009.45,4835,4009.45,45.331248955848416,563642,751479.4795088198,751479.4795088198,563642,18.392093357318416,7.142857142857143,28.571428571428573,-1.4702010422897827,2.879007425461623,4.349208467751406,45.331248955848416,13.164556962025431,30.210970464135205
1474502400,597,598.54,594.78,596.21,3959,3967.6,3959,3967.6,44.78443393932412,559683,750531.8465300965,750531.8465300965,559683,18.454606846385044,0,21.428571428571427,-1.974183841800194,1.881478665501163,3.855662507301357,44.78443393932412,11.511354737666602,19.870873520150596
1474588800,595.99,603.3,595.14,602.96,3723,3922.85,3723,3922.85,50.30080494907728,563406,753944.5965300966,753944.5965300966,563406,17.882134574694756,14.285714285714286,14.285714285714286,-1.7909626259214262,1.616959224899574,3.4079218508210003,50.30080494907728,29.13077525450291,17.93556231806501
1474675200,602.96,605.94,601.08,603.68,2577,3825.35,2577,3825.35,50.864700866005954,565983,754124.8804807138,754124.8804807138,565983,17.016589314747872,7.142857142857143,7.142857142857143,-1.5673585521673679,1.4487236606117904,3.0160822127791582,50.864700866005954,31.01018010963189,23.88410336726716
1474761600,603.69,605.99,599.42,601.67,2511,3803.45,2511,3803.45,49.18687430703573,563472,753333.7434944124,753333.7434944124,563472,16.400455162497536,0,0,-1.5008148755153723,1.1400636183849429,2.640878493900315,49.18687430703573,45.58749369641929,35.24281635351806
1474848000,601.67,607.99,600.02,607.08,4250,3811,4250,3811,53.621278101761064,567722,756613.2290653032,756613.2290653032,567722,15.558146985684646,50,64.28571428571429,-1.0592542162775986,1.316810723553317,2.3760649398309157,53.621278101761064,72.8693898134141,49.82235453982179
1474934400,607.04,607.54,601.38,605.71,4298,3794.6,4298,3794.6,52.374785881049505,563424,758357.5472471215,758357.5472471215,563424,14.776003678644104,42.857142857142854,57.142857142857146,-0.8360570231028568,1.3309936609523447,2.1670506840552015,52.374785881049505,65.96066565809387,61.47251638930911
1475020800,605.71,606,603.18,605.04,3668,3719.4,3668,3719.4,51.741311922634466,559756,759528.1855449937,759528.1855449937,559756,14.049727750677887,35.714285714285715,50,-0.7148482779900434,1.2734903365676473,1.9883386145576907,51.741311922634466,62.581946545637635,67.13733400571523
1475107200,604.96,606.89,603.56,605.99,4071,3700.55,4071,3700.55,52.61643220576966,563827,761398.6450044533,761398.6450044533,563827,13.233160100446787,28.571428571428573,42.857142857142854,-0.5589039797756983,1.289708639838068,1.8486126196137662,52.61643220576966,67.37266767523947,65.30509329299035
1475193600,605.99,608.99,605,608.99,4589,3792.1,4589,3792.1,55.36883980264372,568416,765987.6450044533,765987.6450044533,568416,12.438990884300338,21.428571428571427,35.714285714285715,-0.2572629015641088,1.5270339926586303,1.784296894222739,55.36883980264372,82.50126071608663,70.81862497898794
1475280000,608.99,617.19,608.98,615.65,3440,3753.15,3440,3753.15,60.81117063000746,571856,768137.1212529306,768137.1212529306,571856,12.837245266434502,100,28.571428571428573,0.3540445757402231,2.226852613898018,1.8728080381577947,60.81117063000746,93.72964169381078,81.20119002837897
1475366400,615.65,615.9,608.66,612.4,2859,3700.15,2859,3700.15,57.148915706415636,568997,768231.8947335936,768231.8947335936,568997,13.149898825103485,92.85714285714286,21.428571428571427,0.4941592170257689,2.490507059440006,1.996347842414237,57.148915706415636,80.4967426710095,85.57588169363567
1475452800,612.42,615.24,610.7,612.99,4397,3727.7,4397,3727.7,57.647566949949095,573394,768270.6348216992,768270.6348216992,573394,13.440219986724685,85.71428571428571,14.285714285714286,0.575527816438274,2.7157576129620793,2.1402297965238053,57.647566949949095,82.89902280130279,85.7084690553744
1475539200,612.99,613.23,606.93,610.34,5023,3794.65,5023,3794.65,54.57562935460609,568371,768685.2316470961,768685.2316470961,568371,12.99993833853039,78.57142857142857,7.142857142857143,0.40772908338815883,2.6498911507590037,2.242162067370845,54.57562935460609,72.10912052117261,78.501628664495
1475625600,610.33,614.24,609.22,613.16,4405,3819.3,4405,3819.3,57.189985213532914,572776,771194.8531610402,771194.8531610402,572776,12.749250203198326,71.42857142857143,0,0.44070670441113613,2.793045447884765,2.352338743473629,57.189985213532914,82.01695671575158,79.00836667940904
1475712000,613.16,613.39,610.3,611.88,3885,3807.3,3885,3807.3,55.625066193975954,568891,771282.8628697782,771282.8628697782,568891,12.516468363247126,64.28571428571429,0,0.3351414317182462,2.7712655331214364,2.4361241014031902,55.625066193975954,75.91836734693858,76.68148152795429
1475798400,611.78,618.7,609.89,617.98,5083,3917.55,5083,3917.55,61.089478766177905,573974,775535.0433465091,775535.0433465091,573974,13.121935925722813,100,0,0.6184845671582173,3.209229810350962,2.5907452431927447,61.089478766177905,96.26556016597497,84.73362807622175
1475884800,618.11,620,617.55,619.5,2742,3904.05,2742,3904.05,62.33414256494408,576716,777157.8596730398,777157.8596730398,576716,13.86711848397221,100,7.142857142857143,0.8370400913260463,3.6370453573503028,2.8000052660242565,62.33414256494408,97.57045675413023,89.91812808901464
1475971200,619.46,619.59,617,617.42,2270,3855.4,2270,3855.4,59.527993828262815,574446,775624.0758892559,775624.0758892559,574446,14.430606815096594,92.85714285714286,0,0.7718795807425871,3.7648547419524903,2.992975161209903,59.527993828262815,87.0870870870869,93.64103466906408
1476057600,617.43,619.2,615.46,618.72,3851,3821.8,3851,3821.8,60.71824942181848,578297,778486.5839106461,778486.5839106461,578297,14.588159159884292,85.71428571428571,0,0.7462516117115872,3.925789675849387,3.1795380641378,60.71824942181848,93.1256713211602,92.59440505412583
1476144000,618.72,647.03,618.13,642.12,6278,3893.95,6278,3893.95,74.9811955023085,584575,782631.3673016496,782631.3673016496,584575,17.41425672344817,100,0,2.1554148463339304,5.873806622055213,3.7183917757212823,74.9811955023085,88.80273660205253,89.6718316700999
1476230400,642.3,643.58,631.91,635.79,4296,3910.8,4296,3910.8,67.80860924538776,580279,781192.0048337833,781192.0048337833,580279,20.03849017532891,92.85714285714286,0,2.487794973861165,6.828135493047739,4.340340519186574,67.80860924538776,74.14308718656544,85.35716503659278
1476316800,635.9,639.85,632,635.66,3795,3914.4,3795,3914.4,67.66545153984806,576484,780935.7819038469,780935.7819038469,576484,22.475278380646742,85.71428571428571,0,2.51784372279438,7.487645172679549,4.9698014498851695,67.66545153984806,72.94789436117057,78.6312393832629
1476403200,635.8,639.99,624.08,638.03,4323,4001.7,4323,4001.7,68.9523614432407,580807,784193.6555682089,784193.6555682089,580807,23.21955924641515,78.57142857142857,0,2.510627300077145,8.108085574981601,5.597458274904456,68.9523614432407,77.5561097256858,74.88236375780731
1476489600,638.03,639.99,636,638.16,647,3908.5,647,3908.5,69.02518464315528,581454,784247.1668464043,784247.1668464043,581454,23.910677193200105,71.42857142857143,21.428571428571427,2.3317582921030846,8.512156140033312,6.1803978479302275,69.02518464315528,77.88029925187033,76.12810111290894
1476576000,638.16,643.91,637.87,641.92,2487,3820.35,2487,3820.35,71.13408331900794,583941,785095.3820781924,785095.3820781924,583941,24.9040266656467,64.28571428571429,14.285714285714286,2.281020948962449,9.031674034133289,6.75065308517084,71.13408331900794,87.25685785536157,80.89775561097261
1476662400,642.1,643.47,636.27,639.56,3891,3800,3891,3800,68.00445203159066,580050,784760.3237448591,784760.3237448591,580050,25.51893125260179,57.142857142857146,7.142857142857143,1.9174907756735475,9.147516554762774,7.230025779089226,68.00445203159066,81.37157107231914,82.16957605985039
1476748800,639.56,640,632.15,635.11,4068,3820,4068,3820,62.427179807101155,575982,783760.1657830756,783760.1657830756,575982,25.329701450342906,50,0,1.2392157019156276,8.77904540648376,7.539829704568133,62.427179807101155,68.4739486908226,79.03412587283448
1476835200,635.12,636.99,625.6,629.79,4400,3836.45,4400,3836.45,56.46506127774608,571582,782597.3914195988,782597.3914195988,571582,24.10002761780334,42.857142857142854,0,0.3408751315548795,7.965923619011733,7.625048487456853,56.46506127774608,53.58104469574579,67.80885481962922
1476921600,629.79,629.99,626.01,628.05,4123,3813.15,4123,3813.15,54.627423514754476,567459,782700.9843844229,782700.9843844229,567459,22.958187630445178,35.714285714285715,7.142857142857143,-0.420615418473143,7.099279214365424,7.519894632838567,54.627423514754476,48.89606892837904,56.98368743831585
1477008000,628.19,633.41,627.5,630.83,4128,3847.55,4128,3847.55,57.03339970866961,571587,783224.8422524433,783224.8422524433,571587,22.342840840112597,28.571428571428573,0,-0.7669979259698003,6.561147225376317,7.328145151346117,57.03339970866961,48.685460880582944,50.38752483490263
1477094400,630.67,658,629.32,652.75,4542,3931.7,4542,3931.7,70.37349100164016,576129,786103.9761436566,786103.9761436566,576129,23.87754444043342,100,14.285714285714286,0.38817741791699767,7.813366923742365,7.425189505825367,70.37349100164016,87.65867418899857,61.746734665986885
1477180800,653.03,655.8,645.33,651.04,3017,3862.7,3017,3862.7,68.58455670663774,573112,786377.7249497693,786377.7249497693,573112,25.302626355017043,92.85714285714286,7.142857142857143,0.9150478018109807,8.568999258089093,7.653951456278112,68.58455670663774,83.63892806770089,73.3276877124275
1477267200,651.05,652.93,645.81,649.98,3623,3792.7,3623,3792.7,67.44010370633472,569489,786998.5198935897,786998.5198935897,569489,26.625916704273266,85.71428571428571,0,1.0598852953815676,8.978808075505071,7.918922780123504,67.44010370633472,79.88462503135194,83.72740909601717
1477353600,649.98,657.5,648.99,654.3,4777,3811.3,4777,3811.3,69.66198738423262,574266,788182.9464505814,788182.9464505814,574266,28.151551435648415,78.57142857142857,0,1.2986026921169174,9.54217614526965,8.243573453152733,69.66198738423262,89.09198113207532,84.20517807704276
1477440000,654.3,678,652.51,674,5801,3907.1,5801,3907.1,77.27700669378767,580067,792163.3109072311,792163.3109072311,580067,30.54652728756898,100,14.285714285714286,2.56220412430131,11.44632860852937,8.88412448422806,77.27700669378767,92.58160237388725,87.18606951243821
1477526400,674,692.41,673.54,691.21,6754,3990.65,6754,3990.65,81.6178937066806,586821,798058.296598805,798058.296598805,586821,33.22533408494071,100,7.142857142857143,4.237197175138618,14.180620953151333,9.943423778012715,81.6178937066806,98.24381677154993,93.30580009250421
1477612800,691.01,691.19,683.2,689.95,4354,4071.25,4354,4071.25,80.40679359682217,582467,801060.8673121968,801060.8673121968,582467,35.712797539643034,92.85714285714286,0,4.893866938876567,16.060757451608424,11.166890512731857,80.40679359682217,96.31791647956904,95.71444520833545
1477699200,689.95,725.64,689.39,714.28,6553,4285.4,6553,4285.4,85.02698662467067,589020,803506.7180708174,803506.7180708174,589020,38.742493379715484,100,28.571428571428573,6.499787584763416,19.291624993686128,12.791837408922712,85.02698662467067,88.64454218312673,94.40209181141529
1477785600,714.28,714.98,692.04,697.41,3727,4279.2,3727,4279.2,72.29688552789166,585293,801524.6169374259,801524.6169374259,585293,41.555782374068464,92.85714285714286,21.428571428571427,5.972393199654896,20.25732890849133,14.284935708836436,72.29688552789166,71.78128748500598,85.58124871590064
1477872000,697.39,709.68,681.01,696.9,4428,4186.7,4428,4186.7,71.94619609581807,580865,802004.9475966516,802004.9475966516,580865,42.83402537663034,85.71428571428571,14.285714285714286,5.165969855307861,20.742398027971262,15.576428172663402,71.94619609581807,71.2714914034386,77.2324403571905
1477958400,697.07,737.5,695.74,730.7,6877,4315.75,6877,4315.75,79.16083514203063,587742,806642.311581326,806642.311581326,587742,44.66300364014862,100,7.142857142857143,6.404740364576931,23.582353628384567,17.177613263807636,79.16083514203063,93.92314566577305,78.99197485140593
1478044800,730.7,744.6,720,744.6,5050,4378.5,5050,4378.5,81.29162975636501,592792,811692.311581326,811692.311581326,592792,46.49079737080592,100,0,7.5758911534282625,26.647477205592963,19.0715860521647,81.29162975636501,100,88.39821235640393
1478131200,744.61,746.16,672.06,690,10315,4678.1,10315,4678.1,56.74659650383003,582477,806371.9431602734,806371.9431602734,582477,44.605798096867524,100,0,4.254488592053043,24.389696792231007,20.135208200177964,56.74659650383003,52.67149839878646,82.19821468818655
1478217600,690,708.33,683.8,706.32,5201,4905.8,5201,4905.8,60.578086452484165,587678,810720.5982764576,810720.5982764576,587678,42.85544162821044,92.85714285714286,0,2.8076059144549887,23.6447155932467,20.837109678791712,60.578086452484165,65.90208832591583,72.85786224156747
1478304000,706.05,707.99,697.72,706.99,2945,4928.7,2945,4928.7,60.73187602476069,590623,813092.0831839552,813092.0831839552,590623,41.23011062160029,85.71428571428571,0,1.60633842479778,22.84503270978894,21.23869428499116,60.73187602476069,61.15243479123278,59.908673838645065
1478390400,706.98,719.83,705.86,717.02,2946,4881.45,2946,4881.45,63.05541918928253,593569,814852.9350092951,814852.9350092951,593569,40.196254514153836,78.57142857142857,0,1.2156623665276456,22.758272243150714,21.542609876623068,63.05541918928253,70.96163428001995,66.00538579905621
1478476800,717.04,717.32,701.35,706.42,4149,4885.5,4149,4885.5,59.07693048686749,589420,813338.303199652,813338.303199652,589420,38.93709789392252,71.42857142857143,0,0.03420005322638531,21.58535994315605,21.551159889929664,59.07693048686749,59.10260368426466,63.73889091850583
1478563200,706.41,716.45,704.16,711.15,4311,4881.05,4311,4881.05,60.28122179376268,593731,813931.1095462752,813931.1095462752,593731,37.76788103227914,64.28571428571429,0,-0.6027307204300314,20.797746489392125,21.400477209822157,60.28122179376268,62.61612386545648,64.2267872765804
1478649600,711.3,747.26,710.05,720.97,11996,5274.7,11996,5274.7,62.733220540064515,605727,808976.0297290218,808976.0297290218,605727,37.82964307793994,100,0,-0.5387650566691278,20.72702088898575,21.265785945654876,62.733220540064515,65.03989361702135,62.25287372224753
1478736000,721,723.61,705.84,712.91,4388,5287.7,4388,5287.7,59.48716552239643,601339,808079.6628184984,808079.6628184984,601339,37.59363515581467,92.85714285714286,50,-1.1786761448628411,19.792440764576327,20.971116909439168,59.48716552239643,54.3218085106383,60.65927533103874
1478822400,713,718.99,712.5,716.9,3308,5226,3308,5226,60.57473119982746,604647,809257.086547312,809257.086547312,604647,37.374484942412636,85.71428571428571,42.857142857142854,-1.4545290578183128,19.152955587166275,20.607484644984588,60.57473119982746,59.6276595744681,59.66312056737595
1478908800,716.56,716.99,702.42,704.53,3074,5228.85,3074,5228.85,55.59211381798164,601573,807073.4283455275,807073.4283455275,601573,36.44060193219455,78.57142857142857,35.714285714285715,-2.5284785081039836,17.446886509854608,19.97536501795859,55.59211381798164,43.178191489361716,52.37588652482273
1478995200,704.63,705.94,685.7,704.01,4140,5254.7,4140,5254.7,55.38586885846261,597433,810423.882890982,810423.882890982,597433,34.512008821487925,71.42857142857143,28.571428571428573,-3.28435897126986,15.869916303871264,19.154275275141124,55.38586885846261,42.48670212765961,48.430851063829834
1479081600,704.01,708.57,695.07,708.32,4782,5254.95,4782,5254.95,56.81592276758446,602215,815028.7717798708,815028.7717798708,602215,32.84956679665672,64.28571428571429,21.428571428571427,-3.4855304177244832,14.797362252985522,18.282892670710005,56.81592276758446,48.218085106383086,44.62765957446817
1479168000,708.4,716.3,673.85,712.29,4631,5196.45,4631,5196.45,58.1467066351676,606846,818784.8455136754,818784.8455136754,606846,30.869257103863497,57.142857142857146,14.285714285714286,-3.3422290361864775,14.105106375476907,17.447335411663385,58.1467066351676,53.49734042553191,48.0673758865249
1479254400,711.92,743.8,710,739.85,6151,5166.3,6151,5166.3,65.98362472331604,612997,823498.1857503618,823498.1857503618,612997,29.577216122385657,50,7.142857142857143,-1.4774545493292734,15.600517225001795,17.07797177433107,65.98362472331604,90.14627659574472,63.95390070921993
1479340800,738.07,750.01,729.01,730.71,4143,5155.75,4143,5155.75,61.84753696733364,608854,820025.9571789332,820025.9571789332,608854,28.62525787328702,100,0,-0.9701894748610087,15.86523493075481,16.835424405615818,61.84753696733364,74.65861344537821,72.76741015555164
1479427200,729.61,751,728.89,748.54,4607,5058.45,4607,5058.45,66.28709360576813,613461,823607.7902861245,823607.7902861245,613461,27.78186961478481,100,78.57142857142857,0.38299697705492264,17.31417062693447,16.931173649879547,66.28709360576813,96.81140635126373,87.20543213079559
1479513600,748.55,752.3,738,750.77,2905,5017.35,2905,5017.35,66.80732608591416,616366,825891.1609154951,825891.1609154951,616366,27.055168775593852,100,71.42857142857143,1.1990258071521183,18.429955908819693,17.230930101667575,66.80732608591416,98.04971319311667,89.83991099658624
1479600000,750.77,753.81,715,731.99,4257,5008.8,4257,5008.8,58.605425509427675,612109,825361.3667902697,825361.3667902697,612109,25.152452515580208,100,64.28571428571429,0.2920551275065968,17.59599901105082,17.303943883544225,58.605425509427675,72.71135567783897,89.19082507407315
1479686400,731.72,738.47,730,736.4,2934,4811.65,2934,4811.65,59.85189915881561,615043,826861.2747005413,826861.2747005413,615043,23.385644559853255,92.85714285714286,57.142857142857146,-0.1680473918536478,17.093884643727165,17.261932035580813,59.85189915881561,78.22661330665335,82.99589405920302
1479772800,736.39,748.77,726.38,746.66,4219,4770.1,4219,4770.1,62.66839911005599,619262,830285.0902431943,830285.0902431943,619262,22.214302325549998,85.71428571428571,50,0.04977407605800721,17.324149630653324,17.274375554595316,62.66839911005599,91.05802901450727,80.66533266633321
1479859200,746.66,747.12,734,741.52,3562,4432.45,3562,4432.45,60.38301107569717,615700,830806.3585358772,830806.3585358772,615700,21.12662739369697,78.57142857142857,42.857142857142854,-0.3018188636389212,16.897101975046667,17.198920838685588,60.38301107569717,84.62981490745376,84.63815240953816
1479945600,741.51,743.99,727,737.99,3408,4342.8,3408,4342.8,58.79715442939065,612292,831807.2955576547,831807.2955576547,612292,19.69692522397788,71.42857142857143,35.714285714285715,-0.8884442947675844,16.08836547022611,16.976809764993693,58.79715442939065,80.21510755377695,85.30098382524602
1480032000,737.99,739.99,729,739.74,3100,4350.55,3100,4350.55,59.36689506687197,615392,834766.2582510123,834766.2582510123,615392,18.369344637810148,64.28571428571429,28.571428571428573,-1.2526494545184192,15.410997946845669,16.663647401364088,59.36689506687197,82.40370185092551,82.4162081040521
1480118400,739.51,739.98,726,735.7,2640,4335.25,2640,4335.25,57.39382215558983,612752,835789.777564317,835789.777564317,612752,17.169826157594358,57.142857142857146,21.428571428571427,-1.8250028928842887,14.382393785258728,16.207396678143017,57.39382215558983,77.35117558779399,79.98999499749884
1480204800,735.69,737.95,728.01,729.24,2622,4258.9,2622,4258.9,54.2869047022066,610130,833816.6829969125,833816.6829969125,610130,16.05598756882255,50,14.285714285714286,-2.6480951224611005,12.897277775066641,15.545372897527741,54.2869047022066,69.27213606803406,76.34233783558454
1480291200,729.24,736.44,729,729.77,3822,4234.45,3822,4234.45,54.50450575364183,613952,830785.7959001383,830785.7959001383,613952,15.021708879248735,42.857142857142854,7.142857142857143,-3.133076699457444,11.629027023205936,14.76210372266338,54.50450575364183,69.93496748374189,72.18609304652334
1480377600,730.18,734.36,728.2,732.37,3771,3823.2,3771,3823.2,55.62055758317687,617723,832120.3381079305,832120.3381079305,617723,14.122983739082542,35.714285714285715,0,-3.241470054391092,10.710266154674514,13.951736209065606,55.62055758317687,51.06140150650544,63.42283501942716
1480464000,732.44,745,729.17,742.69,3892,3798.4,3892,3798.4,59.83249461249881,621615,834876.4543429273,834876.4543429273,621615,13.75674824524476,28.571428571428573,0,-2.6080827180766093,10.691632811469844,13.299715529546454,59.83249461249881,71.34759082710666,64.11465327245135
1480550400,742.51,754.9,741.59,754,4136,3839.8,4136,3839.8,63.8785581360798,625751,838453.1154999521,838453.1154999521,625751,14.070618166988242,100,21.428571428571427,-1.4738409907055878,11.457414291164469,12.931255281870056,63.8785581360798,97.74436090225569,73.38445107862262
1480636800,754,780,753.53,769.25,6008,3986.5,6008,3986.5,68.48779060118757,631759,839581.1759457398,839581.1759457398,631759,15.621906768670216,100,14.285714285714286,0.16966851741021394,13.143340928632824,12.97367241122261,68.48779060118757,83.46153846153847,84.1844967303003
1480723200,769.78,771.92,759,766.98,3118,3935.4,3118,3935.4,67.11493950647055,628641,840314.8230045633,840314.8230045633,628641,17.06238904166062,92.85714285714286,7.142857142857143,0.9277495411970769,14.133359337718957,13.20560979652188,67.11493950647055,79.96923076923079,87.05837671100834
1480809600,766.86,769.76,762.83,767.99,2721,3832.35,2721,3832.35,67.42779061348513,631362,841645.8749526152,841645.8749526152,631362,18.399979723723135,85.71428571428571,0,1.2983286931236115,14.828520662926394,13.530191969802782,67.42779061348513,77.75925925925928,80.39667616334286
1480896000,767.94,767.99,748.6,752,4790,3840.3,4790,3840.3,58.01737322997565,626572,838535.7099190928,838535.7099190928,626572,18.357994643737037,78.57142857142857,35.714285714285715,0.31874336881310583,13.928621180819164,13.609877812006058,58.01737322997565,48.148148148148145,68.62554605887942
1480982400,752.01,761.58,752,759.8,4467,3756.1,4467,3756.1,60.88513219368445,631039,841342.7391466502,841342.7391466502,631039,18.319008498035654,71.42857142857143,28.571428571428573,0.06174833082768849,13.687063225540669,13.62531489471298,60.88513219368445,62.59259259259251,62.833333333333336
1481068800,759.93,768.9,750.26,764.34,4537,3775.8,4537,3775.8,62.49115838466648,635576,843659.9194041609,843659.9194041609,635576,18.712524039957813,64.28571428571429,21.428571428571427,0.06294466898402007,13.703995730943006,13.641051061958986,62.49115838466648,71.00000000000006,60.580246913580254
1481155200,764.34,772.82,761.71,767.89,4796,3785.25,4796,3785.25,63.744701916596874,640372,844199.523364557,844199.523364557,640372,19.298311067645837,57.142857142857146,14.285714285714286,0.16258469487234173,13.844281930549414,13.681697235677072,63.744701916596874,77.57407407407403,70.38888888888889
1481241600,767.9,773.22,765.97,773.22,3887,3834.35,3887,3834.35,65.60338364687325,644259,848086.523364557,848086.523364557,644259,19.865389823781328,50,7.142857142857143,0.4319289004439657,14.221608361232029,13.789679460788063,65.60338364687325,87.4444444444445,78.67283950617288
1481328000,773.15,776.99,770,775.87,3319,3787.45,3319,3787.45,66.52233404412796,647578,850341.923936803,850341.923936803,647578,20.615667279801762,42.857142857142854,0,0.6215051374327363,14.566560882578983,13.945055745146247,66.52233404412796,92.05616464704752,85.6915610551887
1481414400,776.05,776.08,765,771.05,3061,3793.8,3061,3793.8,63.21424529412202,644517,850623.7127454672,850623.7127454672,644517,20.773035952123085,35.714285714285715,0,0.27301197282963763,14.286320711183293,14.013308738353656,63.21424529412202,82.72200772200762,87.40753893783324
1481500800,771.05,782,770.88,778.94,4358,3800.75,4358,3800.75,66.17913807960524,648875,852583.245119568,852583.245119568,648875,21.298282156598866,100,7.142857142857143,0.41603617660312153,14.533353959107558,14.117317782504436,66.17913807960524,94.31226765799266,89.69681334234929
1481587200,779.26,790.34,772.76,776.18,5387,3892,5387,3892,64.2289482140977,643488,849292.2109898751,849292.2109898751,643488,22.27103253404157,100,0,0.1790300292432967,14.341105319058556,14.16207528981526,64.2289482140977,76.85139774399205,84.62855770799746
1481673600,776.65,781.8,773.2,777.66,4458,3944.5,4458,3944.5,64.82749269941506,647946,849458.0900596426,849458.0900596426,647946,23.17430074166694,92.85714285714286,0,-0.013568676980806771,14.14511444358925,14.158683120570057,64.82749269941506,73.98974358974345,81.71780299724274
1481760000,777.66,780,775,776.16,5904,4084.7,5904,4084.7,63.66476480948936,642042,846293.5460596425,846293.5460596425,642042,24.013049791604782,85.71428571428571,0,-0.3583830293986896,13.710704333821695,14.069087363220385,63.66476480948936,66.02779108768553,72.2896441404737
1481846400,776.16,785,774.8,780.98,5689,4237.15,5689,4237.15,65.7881826975795,647731,847498.2754714072,847498.2754714072,647731,25.09902679758207,78.57142857142857,21.428571428571427,-0.37638299906626216,13.598608614387558,13.97499161345382,65.7881826975795,77.5754671777671,72.5310006183987
1481932800,780.85,791.97,779.5,788.57,4318,4321.95,4318,4321.95,68.87296597173314,652049,849461.6323278628,849461.6323278628,652049,26.49919990711986,100,14.285714285714286,-0.010965675154826826,13.961284519510286,13.972250194665113,68.87296597173314,92.16047959418958,78.58791261988075
1482019200,788.98,791.96,787.19,790.72,2791,4270.4,2791,4270.4,69.70623106550799,654840,850801.5463739843,850801.5463739843,654840,27.79936065169066,92.85714285714286,7.142857142857143,0.22847130222533707,14.257839322446785,14.029368020221447,69.70623106550799,97.11782338021673,88.95125671739113
1482105600,790.71,794.99,789,790.81,5465,4355.1,5465,4355.1,69.74274542617412,660305,848639.2675759875,848639.2675759875,660305,29.178528339578495,100,0,0.24440943726222564,14.33487981679923,14.090470379537004,69.74274542617412,90.65504135926658,93.31111477789098
1482192000,791,799.21,788.58,798.99,5876,4454.3,5876,4454.3,72.93576529569897,666181,854272.046503551,854272.046503551,666181,30.69065126020933,100,7.142857142857143,0.6351551661739041,14.884414337254384,14.24925917108048,72.93576529569897,99.55056179775275,95.77447551241202
1482278400,798.98,834.5,798.88,834.5,8390,4667,8390,4667,81.8768173207411,674571,862662.046503551,862662.046503551,674571,33.355812833322304,100,0,2.983028601944593,17.97804492351122,14.995016321566627,81.8768173207411,100,96.73520105233979
1482364800,834.15,875.75,832.38,856.02,8756,4804.4,8756,4804.4,85.0912868158924,683327,863451.4391712936,863451.4391712936,683327,36.53727829461021,100,0,5.5349043209324655,21.91364672273221,16.378742401799744,85.0912868158924,82.18510158013542,93.9118877926294
1482451200,856.45,918.5,855.45,917.26,12704,5283.7,12704,5283.7,90.34138397192392,696031,875655.7417882642,875655.7417882642,696031,39.89655460694514,100,14.285714285714286,10.603093617190094,29.632609423287363,19.02951580609727,90.34138397192392,99.19218241042346,93.79242799685296
1482537600,917.28,918.19,880.1,891.5,6393,5467.3,6393,5467.3,77.91256054980222,689638,873089.4784645572,873089.4784645572,689638,43.015882611256146,92.85714285714286,7.142857142857143,11.406473309614192,33.28760744311501,21.881134133500815,77.91256054980222,82.41042345276873,87.92923581444256
1482624000,891.59,897.4,851.11,896.12,5323,5493.95,5323,5493.95,78.4842761469041,694961,878118.0978207897,878118.0978207897,694961,43.71095942734271,85.71428571428571,0,11.407421441264269,36.14041093508115,24.73298949381688,78.4842761469041,84.83945264869259,88.81401950396162
1482710400,895.94,908.24,890,902.09,3260,5433.6,3260,5433.6,79.23234100197097,698221,879179.7425576318,879179.7425576318,698221,44.57013266873789,78.57142857142857,0,10.965525338881214,38.4398961674184,27.474370828537182,79.23234100197097,88.74022231370937,85.33003280505692
1482796800,902.08,943.36,895,925.2,6693,5541.4,6693,5541.4,81.861384239886,704914,880846.0725824457,880846.0725824457,704914,45.94006471930434,100,0,11.33807008130007,41.64695843016227,30.3088883488622,81.861384239886,89.32769158439118,87.63578884893106
1482883200,925.28,983.46,923.95,982.17,9744,5788.8,9744,5788.8,86.42399272607858,714658,890167.630639915,890167.630639915,714658,47.68345883046646,100,0,14.336585497596012,48.229620220857214,33.8930347232612,86.42399272607858,99.38176938560333,92.48322776123466
1482969600,982.25,988.88,950.5,970.72,8955,6042.2,8955,6042.2,81.9616423659063,705703,890648.2794153189,890648.2794153189,705703,49.356993120150975,100,7.142857142857143,14.424740789091416,51.923960709625476,37.49921992053406,81.9616423659063,91.51718983557551,93.4088836018567
1483056000,970.51,970.51,930.3,960.81,7884,6270.45,7884,6270.45,78.1982522741971,697819,894728.5092089025,894728.5092089025,697819,49.76366697140198,92.85714285714286,0,12.749519791552949,53.43611965997525,40.6865998684223,78.1982522741971,86.5937529850033,92.49757073539406
1483142400,961.52,973.37,949,973.37,3811,6307.95,3811,6307.95,79.48401721366284,701630,898539.5092089025,898539.5092089025,701630,50.18659866849795,85.71428571428571,0,11.461790722601442,55.0138382716741,43.55204754907266,79.48401721366284,92.30998066339433,90.14030782799108
1483228800,973.37,1000,964.37,992.95,4368,6308.45,4368,6308.45,81.33230152847587,705998,901178.9433935783,901178.9433935783,705998,50.97169340447051,100,0,10.906315233649266,57.18494159113425,46.27862635748498,81.33230152847587,96.66540535427114,91.85637966755628
1483315200,992.96,1034.39,990.52,1011.45,7694,6423.8,7694,6423.8,82.8998470815943,713692,900826.4259556936,900826.4259556936,713692,52.108462112855236,100,7.142857142857143,10.74514027008064,59.71005169508578,48.96491142500514,82.8998470815943,90.66758878808834,93.2143249352513
1483401600,1011.52,1036.99,1006.71,1020.67,8592,6630.5,8592,6630.5,83.63729015090507,722284,900156.7720587319,900156.7720587319,722284,53.192015169629656,100,0,10.22283602644925,61.7434564580667,51.52062043161745,83.63729015090507,93.1460249464533,93.49300636293763
1483488000,1020.69,1147,1018,1130.3,16215,7146.05,16215,7146.05,89.45850723907711,738499,912173.4697331504,912173.4697331504,738499,55.01681855503412,100,0,15.886194710589628,71.37836381985448,55.49216910926486,89.45850723907711,94.69200940817493,92.83520771423889
1483574400,1131.1,1175,880,1007,20398,7881.5,20398,7881.5,62.51903089838071,718101,909338.493461964,909338.493461964,718101,52.61058254802283,100,0,10.228468176932623,68.27775433043064,58.04928615349802,62.51903089838071,48.13053814566673,78.6561908334317
1483660800,1007,1032.5,875.01,895.71,14123,8371.75,14123,8371.75,48.36257178260195,703978,898928.0606090844,898928.0606090844,703978,50.269164302775,92.85714285714286,14.285714285714286,-1.4853704770597105,56.19257305717338,57.67794353423309,48.36257178260195,13.77010713513848,52.19755156299342
1483747200,895.78,910,802.07,909,11115,8787.95,11115,8787.95,49.82372036324595,715093,909837.0937787314,909837.0937787314,715093,46.701534687600514,85.71428571428571,100,-8.427214085065287,47.14392592790148,55.571140012966765,49.82372036324595,28.672941302657325,30.19119552782088
1483833600,908.99,953.8,899.16,923.33,5347,8782.05,5347,8782.05,51.41994379599907,720440,909220.5838958618,909220.5838958618,720440,44.06691333160918,78.57142857142857,92.85714285714286,-11.928583038448572,40.66041121490605,52.58899425335462,51.41994379599907,32.51548547984877,24.986177972548234
1483920000,922.04,923.58,886.42,902.66,5871,8781.8,5871,8781.8,48.99859251622328,714569,908481.1791595862,908481.1791595862,714569,41.39321758913622,71.42857142857143,85.71428571428571,-15.296412165079907,33.468479047004735,48.76489121208464,48.99859251622328,26.97289035475825,29.38710571242149
1484006400,902.66,915.1,899.01,907,7178,8721.2,7178,8721.2,49.53592421568495,721747,908432.1064436135,908432.1064436135,721747,38.91050011398276,64.28571428571429,78.57142857142857,-16.77305055795768,27.798578014637542,44.57162857259522,49.53592421568495,28.136647628241214,29.208341154282788
1484092800,906.81,923.98,765,795.77,19443,9255.55,19443,9255.55,38.376484703328536,702304,896515.3501220637,896515.3501220637,702304,37.646326036118325,57.142857142857146,100,-24.324097645134273,14.166506516177378,38.49060416131165,38.376484703328536,7.504878048780483,20.87147201059336
1484179200,795.8,840,734.64,812.25,13159,9278.3,13159,9278.3,40.51470137746997,715463,902742.644541198,902742.644541198,715463,36.80953393585899,50,100,-27.08103467027555,4.639310823467213,31.720345493742762,40.51470137746997,17.62421655009538,17.75524740903907
1484265600,812.25,835.01,782.85,831.42,10467,9482,10467,9482,42.992613843452155,725930,911768.8266730999,911768.8266730999,725930,36.0325126999039,42.857142857142854,92.85714285714286,-26.45520051978544,-1.3486551559890358,25.106545363796403,42.992613843452155,21.977472976655456,15.70218919184382
1484352000,831.42,847.52,822.34,828,4731,9452.4,4731,9452.4,42.65126619165137,721199,909164.7099137671,909164.7099137671,721199,35.06068200599763,35.714285714285715,85.71428571428571,-25.123262464207816,-6.297532716463365,18.82572974774445,42.65126619165137,21.20083567989827,20.267508402216414
1484438400,828,835,819,833.31,2897,9434.25,2897,9434.25,43.40263366497549,724096,911449.7186637671,911449.7186637671,724096,34.20224933827349,28.571428571428573,78.57142857142857,-22.804185352026302,-9.679501942288425,13.124683409737875,43.40263366497549,22.4066672722318,21.861658642928557
1484524800,833.43,840,826.03,834.41,3388,9269,3388,9269,43.56757901865768,727484,912126.3485850269,912126.3485850269,727484,33.29408782391717,21.428571428571427,71.42857142857143,-20.20465547098342,-12.131135928991398,8.07351954199202,43.56757901865768,22.656462893995815,22.08798861537534
1484611200,834.4,909,830.1,906,7226,9143.1,7226,9143.1,53.13942749015873,734710,918802.8428816049,918802.8428816049,734710,31.078939746561307,14.285714285714286,64.28571428571429,-13.021057260267929,-8.202802033342891,4.818255226925038,53.13942749015873,38.91361613225543,27.992248766161058
1484697600,906.09,916.7,850,887.99,6875,9039.1,6875,9039.1,50.80479836823019,727835,919759.3646207353,919759.3646207353,727835,28.885800944277534,7.142857142857143,57.142857142857146,-9.029214971891319,-6.468263487939112,2.560951483952208,50.80479836823019,34.82378054319194,32.13128652314777
1484784000,887.98,907,883.08,902.92,4991,8894.45,4991,8894.45,52.66151719223446,732826,923047.7492361199,923047.7492361199,732826,26.849314913585467,0,50,-5.124429176515263,-3.8445849866918707,1.279844189823392,52.66151719223446,56.49634056268044,43.41124574604265
1484870400,902.92,904.58,890,894.31,2515,8829.65,2515,8829.65,51.45541933887258,730311,922019.6696750773,922019.6696750773,730311,24.95829217079997,0,42.857142857142854,-2.96949222374269,-2.4320210898549703,0.5374711338877195,51.45541933887258,72.85544807446614,54.72518972677955
1484956800,894.31,930,891.28,925.06,4316,8827.05,4316,8827.05,55.38542012400676,734627,925234.3762866475,925234.3762866475,734627,23.660601846399214,7.142857142857143,35.714285714285715,0.4943393400704743,1.1553953089758124,0.6610559689053381,55.38542012400676,86.88629311918233,72.07936058544301
1485043200,925.06,946.24,902,931.22,3698,8627.25,3698,8627.25,56.15124492430847,738325,926421.3473535553,926421.3473535553,738325,22.767299990395546,0,28.571428571428573,3.0265778616689936,4.44427829599158,1.4177004343225865,56.15124492430847,92.90170132325143,84.21448083896668
1485129600,929.45,930,910.63,910.7,2745,8334.9,2745,8334.9,52.894071065091396,735580,923696.1873122543,923696.1873122543,735580,21.93780540982071,92.85714285714286,21.428571428571427,3.1326143309201004,5.333468347972712,2.2008540170526114,52.894071065091396,83.20415879017015,87.66405107753468
1485216000,911.78,923,880,887,6351,7841.7,6351,7841.7,49.3345742487122,729229,919412.9547541148,919412.9547541148,729229,20.43001814190511,85.71428571428571,14.285714285714286,1.5023157175062876,4.078748663935471,2.5764329464291835,49.3345742487122,72.00378071833649,82.70321361058608
1485302400,887,903.98,886.99,896.01,4471,7045.35,4471,7045.35,50.69304692889909,733700,919689.2672909012,919689.2672909012,733700,19.0299299645549,78.57142857142857,7.142857142857143,0.9532305620028145,3.767971148932702,2.8147405869298874,50.69304692889909,76.2618147448015,77.15658475110276
1485388800,896.75,921.95,896,917.02,4670,6572.7,4670,6572.7,53.80357097607986,738370,922584.8472523656,922584.8472523656,738370,18.150961431004365,71.42857142857143,0,1.8742523670461528,5.157556045737579,3.283303678691426,53.80357097607986,82.11640859293713,76.79400135202508
1485475200,917.02,924.47,911,922.63,3668,6200.35,3668,6200.35,54.62666154227337,742038,925250.7507416009,925250.7507416009,742038,17.394060297864662,64.28571428571429,0,2.6813634262599857,6.635007961516408,3.953644535256422,54.62666154227337,81.44451430367808,79.94091254713895
1485561600,922.98,925.5,921.81,924.98,2567,6061.35,2567,6061.35,54.98844848239308,744605,927094.2602266958,927094.2602266958,744605,16.71698549853996,57.142857142857146,7.142857142857143,3.160610387715969,7.904407519901383,4.743797132185414,54.98844848239308,83.29141779314682,82.28411356325405
1485648000,924.69,927.47,915,916.54,2537,5894.65,2537,5894.65,53.343350723956846,742068,925183.880916351,925183.880916351,742068,15.879934815960825,50,0,2.713439303850878,8.135596261999012,5.422156958148134,53.343350723956846,75.29323683553778,80.00972297745427
1485734400,916.56,923.95,914.69,923.23,3505,5711,3505,5711,54.50520148035931,745573,928143.8269206706,928143.8269206706,745573,15.092749307620808,42.857142857142854,0,2.6684255605253053,8.757688908804766,6.089263348279461,54.50520148035931,80.18770449457553,79.59078637442009
1485820800,923.26,972.3,922.94,970.01,6693,5073.5,6693,5073.5,61.68934722291379,752266,934215.79896281,934215.79896281,752266,15.597551069267007,100,0,5.43020420280519,12.877018601785949,7.4468143989807585,61.68934722291379,98.12755519215048,84.5361655074213
1485907200,970.01,992.39,964.22,992.39,4477,4639.4,4477,4639.4,64.57170684838934,756743,938692.79896281,938692.79896281,756743,16.484669561996014,100,0,8.236921404780176,17.74296615495598,9.506044750175803,64.57170684838934,100,92.77175322890872
1485993600,992.75,1010,978.74,1008.38,4075,4319.8,4075,4319.8,66.5104108147464,760818,942345.4381182803,942345.4381182803,760818,17.649420626339783,100,35.714285714285715,10.498103989925369,22.628674737582514,12.130570747657146,66.5104108147464,98.75384615384615,98.96046711533226
1486080000,1008.44,1024.5,994.34,1018.01,6050,4385.75,6050,4385.75,67.65826593981659,766868,945791.6914339301,945791.6914339301,766868,18.997615171644274,100,28.571428571428573,11.869013474041685,26.966837590209252,15.097824116167567,67.65826593981659,95.50865051903114,98.08749889095914
1486166400,1018.48,1044.12,1001.8,1035.54,4677,4474.75,4677,4474.75,69.69454975998576,771545,948572.2519254235,948572.2519254235,771545,20.588997167847182,100,21.428571428571427,13.087159347008836,31.456773299928614,18.369613952919778,69.69454975998576,94.77211796246652,96.34487154511466
1486252800,1035.54,1036.3,1003.02,1016.32,4537,4532.2,4537,4532.2,64.87187876449931,767008,947661.5800504235,947661.5800504235,767008,22.06670902146417,92.85714285714286,14.285714285714286,11.770571299768072,33.08282807762987,21.312256777861798,64.87187876449931,83.06117475018289,91.11398107722691
1486339200,1016.32,1027.7,1014.64,1022.58,4301,4385.95,4301,4385.95,65.70428310684872,771309,948590.2798972841,948590.2798972841,771309,23.43887002839423,85.71428571428571,7.142857142857143,10.533525419432287,34.47916355215216,23.94563813271987,65.70428310684872,86.87545698269567,88.23624989844842
1486425600,1022.64,1058.26,1021.75,1053.95,5379,4311.15,5379,4311.15,69.59277399071568,776688,952699.2996179087,952699.2996179087,776688,25.24632304785642,100,0,10.98963652081083,37.68268378373341,26.69304726292258,69.59277399071568,97.48350557599116,89.14004576962331
1486512000,1053.95,1069.95,1016.49,1056.7,6898,4406.5,6898,4406.5,69.914804409972,783586,956177.976759697,956177.976759697,783586,27.10689052506745,100,0,10.631566375736778,39.98250523259355,29.350938856856775,69.914804409972,92.3828686404139,92.24727706636698
1486598400,1057.22,1079,925,994.24,16370,5099.25,16370,5099.25,55.53005847988477,767216,954528.2209155412,954528.2209155412,767216,25.640985035247642,100,0,5.59617247952087,36.346154456257864,30.749981976736994,55.53005847988477,49.54761904761905,79.80466442134143
1486684800,993.58,1008,961,1001.98,7878,5277.35,7878,5277.35,56.71844993040502,775094,960388.1119793709,960388.1119793709,775094,24.279787080414962,92.85714285714286,0,2.3603315304716475,33.70039638982655,31.340064859354904,56.71844993040502,53.12519018927636,65.0185592924365
1486771200,1001.88,1023.89,995.49,1018.65,4136,5299.25,4136,5299.25,59.24459066693876,779230,962997.8697258498,962997.8697258498,779230,23.390689739191657,85.71428571428571,14.285714285714286,0.9865556999831995,32.5732594843339,31.586703784350703,59.24459066693876,63.27064694784247,55.31448539491269
1486857600,1018.63,1018.88,1008,1010,1261,5225.05,1261,5225.05,57.37334796000502,777969,962200.4726670263,962200.4726670263,777969,22.56509935091287,78.57142857142857,7.142857142857143,-0.7662099971593541,30.62894128790151,31.395151285060866,57.37334796000502,58.006207777980634,58.134014971699884
1486944000,1009.99,1021.5,985.68,1002.82,4688,5141.9,4688,5141.9,55.79794152498153,773281,961998.9226949437,961998.9226949437,773281,21.128691612145193,71.42857142857143,0,-2.5690780129309516,28.183803768897178,30.75288178182813,55.79794152498153,51.1854414968602,57.487432074227826
1487030400,1002.88,1018.97,992.27,1013.92,5874,5212.05,5874,5212.05,57.73033024786172,779155,965650.9226949437,965650.9226949437,779155,19.794884426146634,64.28571428571429,0,-3.1363975278417406,26.832384872025955,29.968782399867695,57.73033024786172,57.74025974025972,55.64396967170024
1487116800,1013.92,1016,1007.66,1014.53,4450,5201.05,4450,5201.05,57.83941152229439,783605,968532.2176589725,968532.2176589725,783605,18.556349182005114,57.142857142857146,57.142857142857146,-3.5618581615957865,25.51645969787296,29.078317859468747,57.83941152229439,58.13636363636361,55.6873549578279
1487203200,1014.58,1041.88,1013.54,1038.94,3631,5199.2,3631,5199.2,62.05884831810544,787236,971409.8556265095,971409.8556265095,787236,18.16072188618435,50,50,-2.3491224533416535,26.14191479279168,28.491037246133335,62.05884831810544,73.98701298701302,63.28787878787884
1487289600,1038.95,1064.6,1036.29,1057.3,6632,5402.45,6632,5402.45,64.90393697300975,793868,974621.6083640581,974621.6083640581,793868,18.37032526699811,42.857142857142854,42.857142857142854,-0.5539133656785147,27.798645539035192,28.352558904713707,64.90393697300975,85.90909090909089,72.67748917748924
1487376000,1057.29,1073.8,1055.6,1062.15,3901,5470.65,3901,5470.65,65.63698148311138,797769,973528.4710014208,973528.4710014208,797769,18.78431328162024,35.714285714285715,35.714285714285715,0.6513567674248826,29.16675486399481,28.51539809656993,65.63698148311138,89.05844155844161,82.98484848484857
1487462400,1062.15,1067.78,1051.26,1059.88,2960,5443.4,2960,5443.4,64.95316266414193,794809,973657.4782653434,973657.4782653434,794809,18.996768494720456,28.571428571428573,28.571428571428573,0.9678160006245875,29.72516809735066,28.757352096726073,64.95316266414193,87.58441558441565,87.5173160173161
1487548800,1059.89,1095,1051.36,1089.82,4361,5326.8,4361,5326.8,69.47086461103945,799170,976983.1904559941,976983.1904559941,799170,19.841193224605252,100,21.428571428571427,2.763957568097357,32.21229905684777,29.448341488750412,69.47086461103945,96.95294117647055,91.19859943977599
1487635200,1089.98,1132.95,1081.95,1128.31,7312,5468.55,7312,5468.55,74.09412005126096,806482,982964.6932010921,982964.6932010921,806482,21.357191789629233,100,14.285714285714286,5.932720054784035,36.86424155723046,30.931521502446422,74.09412005126096,97.7686943976917,94.10201705285935
1487721600,1129.68,1140,1104.9,1128.72,5938,5561.7,5938,5561.7,74.13904613404338,812420,985086.1325173314,985086.1325173314,812420,22.886050865149183,100,7.142857142857143,7.352004468616386,40.12152708821691,32.76952261960052,74.13904613404338,94.75348837209305,96.49170798208517
1487808000,1129.88,1197,1128.22,1186.9,7512,5634.8,7512,5634.8,79.55684294372591,819932,990391.9330407394,990391.9330407394,819932,25.124903786606907,100,0,11.270338418581801,46.85744564282777,35.58710722424597,79.55684294372591,95.72033898305088,96.08084058427862
1487894400,1185.81,1221.93,1103.32,1186.91,12636,6032.75,12636,6032.75,79.5576356645453,832568,995566.2903461943,995566.2903461943,832568,27.485771261438295,100,0,12.811661777478925,51.60168444609462,38.7900226686157,79.5576356645453,85.17671957671959,91.88351564395458
1487980800,1186.91,1189.49,1110,1158,5963,6104.05,5963,6104.05,70.98751304613944,826605,996804.7999700464,996804.7999700464,826605,29.678005345210295,92.85714285714286,14.285714285714286,10.90751502452234,52.42441644926862,41.51690142474628,70.98751304613944,72.93968253968252,84.61224703315106
1488067200,1157.98,1187.33,1130.88,1184.91,4399,6108.95,4399,6108.95,73.81504363336633,831004,1000826.6315023759,1000826.6315023759,831004,31.71365128014144,85.71428571428571,7.142857142857143,10.481074435744986,54.61824446942751,44.13717003368252,73.81504363336633,84.33015873015876,80.81552028218702
1488153600,1184.91,1198.99,1176,1195.81,5694,6124.7,5694,6124.7,74.88284455271734,836698,1004945.4318503533,1004945.4318503533,836698,33.74716701288075,78.57142857142857,0,9.957576876609629,56.58414112944456,46.62656425283493,74.88284455271734,88.62666550552987,81.96550225845711
1488240000,1195.85,1214.94,1179.64,1195.08,6673,6113.45,6673,6113.45,74.6632475755246,830025,1004109.8890741492,1004109.8890741492,830025,35.82311176168756,71.42857142857143,0,8.63579373373647,57.42130642000552,48.78551268626905,74.6632475755246,87.46908106594478,86.80863510054455
1488326400,1192.72,1230,1085.71,1230,8187,5704.3,8187,5704.3,77.98853394273083,838212,1012296.8890741492,1012296.8890741492,838212,34.31972708792532,100,0,9.138367703169834,60.20847231523135,51.07010461206151,77.98853394273083,100,92.03191552382494
1488412800,1230,1298.61,1220,1269.17,8892,5755,8892,5755,81.00070487277631,847104,1014528.6555160778,1014528.6555160778,847104,34.07039133540725,100,0,11.008464491712324,64.83068522670192,53.82222073498959,81.00070487277631,88.77706617871308,92.08204908155268
1488499200,1269.17,1294.99,1255.61,1292.86,8180,5957.2,8180,5957.2,82.55554000839058,855284,1021823.7697872814,1021823.7697872814,855284,33.83886527949762,92.85714285714286,0,12.624676572851541,69.60306645105402,56.97838987820248,82.55554000839058,97.67535880331515,95.48414166067614
1488585600,1293.06,1294.48,1226.41,1273.97,6280,6208.15,6280,6208.15,77.13491408340221,849004,1024319.3478686683,1024319.3478686683,849004,32.82894165878284,85.71428571428571,7.142857142857143,11.250903813022184,71.0420196444802,59.79111583145802,77.13491408340221,90.03840711542354,92.16361069915065
1488672000,1273.94,1278.99,1247.11,1278.97,3875,6167.5,3875,6167.5,77.55500705758962,852879,1028189.4858862341,1028189.4858862341,852879,31.891155439547692,78.57142857142857,0,9.574042821618406,71.75866935848103,62.18462653686262,77.55500705758962,92.05662285136508,93.25679625670132
1488758400,1278.63,1288,1268.78,1284.99,4652,6106.4,4652,6106.4,78.07725728525605,857531,1031384.4078425296,1031384.4078425296,857531,31.18979999024429,71.42857142857143,0,7.838388659383071,71.98261236109147,64.1442237017084,78.07725728525605,93.71365272777629,91.93622756485502
1488844800,1284.99,1288,1050,1237.36,10601,6413.95,10601,6413.95,65.15903924444731,846930,1037474.1923803447,1037474.1923803447,846930,31.185586481076662,64.28571428571429,100,2.715186998785228,67.53820745018993,64.8230204514047,65.15903924444731,75.36301838220504,87.04443132044885
1488931200,1237.32,1246,1128,1150.22,12941,6879.45,12941,6879.45,49.140044344638774,833989,1029406.9045837346,1029406.9045837346,833989,31.18167393684958,57.142857142857146,92.85714285714286,-6.790321467179766,56.33511861743,63.125440084609764,49.140044344638774,40.312135473231194,69.7962688610709
1489017600,1150.22,1214.95,1131.11,1197.3,8475,6971.6,8475,6971.6,55.50474359286357,842464,1034313.589936788,1034313.589936788,842464,31.17804086006729,50,85.71428571428571,-9.963197124692229,50.67144367874448,60.63464080343671,55.50474359286357,59.24942681308074,58.30819355617238
1489104000,1197.3,1360,956.85,1109.02,25216,8037.35,25216,8037.35,44.30794078208466,817248,1028133.2774972493,1028133.2774972493,817248,32.66245246158622,100,100,-17.61622466922055,38.614359966911024,56.230584636131574,44.30794078208466,37.745256108148325,45.76893946482014
1489190400,1111.92,1219,1107,1188.08,10259,8402.3,10259,8402.3,53.378417429410774,827507,1032727.8439258207,1032727.8439258207,827507,34.04083466299665,92.85714285714286,92.85714285714286,-16.956741468987573,35.034657799897104,51.99139926888468,53.378417429410774,57.35582289470418,51.45016860531114
1489276800,1188.11,1244,1150,1235.57,6694,8518.95,6694,8518.95,57.82218146887554,834201,1038221.1966917781,1038221.1966917781,834201,34.80072509564232,85.71428571428571,85.71428571428571,-13.097784576052312,35.61916854881929,48.7169531248716,57.82218146887554,69.13555748480712,54.745545495886596
1489363200,1235.27,1249,1207.98,1245.49,8969,8601.8,8969,8601.8,58.7075594492584,843170,1045655.2776279069,1045655.2776279069,843170,35.4007854957597,78.57142857142857,78.57142857142857,-9.803529582760284,36.462541146421245,46.26607072918153,58.7075594492584,71.5961800818554,66.02918682045562
1489449600,1245.5,1262,1213.55,1247.82,7414,8675.6,7414,8675.6,58.925653689133995,850584,1048729.5244803322,1048729.5244803322,850584,35.67359039928103,71.42857142857143,71.42857142857143,-7.497940931724173,36.89364456452631,44.391585496250485,58.925653689133995,72.17412873620239,70.96862210095502
1489536000,1247.43,1264.55,1240,1263.01,7213,8660.65,7213,8660.65,60.39430213357704,857797,1055037.5941341,1055037.5941341,857797,35.86884446461415,64.28571428571429,64.28571428571429,-5.0951074765000826,38.02270115062538,43.11780862712546,60.39430213357704,75.94195708793252,73.2374219686635
1489622400,1263.55,1277.27,1117.77,1175.11,16500,8853.85,16500,8853.85,49.38918160001643,841297,1050401.042409962,1050401.042409962,841297,37.06909176526976,57.142857142857146,57.142857142857146,-9.32463354456251,31.462016696422324,40.786650240984834,49.38918160001643,54.138658067716705,67.41824796395059
1489708800,1175.11,1175.11,1065.74,1069.57,19142,9512.8,19142,9512.8,39.97118098522367,822155,1032599.6999943088,1032599.6999943088,822155,38.50807516282426,50,50,-18.59396618993277,17.544192503568866,36.13815869350164,39.97118098522367,27.959816445491732,52.680143867047036
1489795200,1068.78,1096,919.44,970,23901,10487.9,23901,10487.9,33.48394614180141,798254,1022387.3560885544,1022387.3560885544,798254,40.53248030306097,42.857142857142854,100,-30.112867363453837,-1.5029255108156576,28.60994185263818,33.48394614180141,11.476302887234418,31.191592466814342
1489881600,970,1062.92,961.59,1019.49,13491,10877.75,13491,10877.75,38.80054422266688,811745,1024313.8810071372,1024313.8810071372,811745,42.41228507613792,35.714285714285715,92.85714285714286,-32.856620390848484,-12.460833635922427,20.395786754926057,38.80054422266688,22.709733067005622,20.71528413324398
1489968000,1019.1,1051.97,1011,1044.97,8879,10988.05,8879,10988.05,41.39764656815144,820624,1030158.8072946647,1030158.8072946647,820624,44.15781807970937,28.571428571428573,85.71428571428571,-31.413823719768647,-18.87149289478475,12.542330824983896,41.39764656815144,28.493281278372976,20.893105744204394
1490054400,1046.76,1120,1042.68,1114.42,12436,11200.5,12436,11200.5,47.888909164857424,833060,1040799.854371747,1040799.854371747,833060,44.4002529611225,21.428571428571427,78.57142857142857,-24.54495145355387,-18.138858491958445,6.406092961595427,47.888909164857424,44.25730887960778,31.82010774166218
1490140800,1114.42,1114.96,985.17,1034.57,14497,11480.75,14497,11480.75,42.11303157224768,818563,1037338.4010240315,1037338.4010240315,818563,44.982260691790124,14.285714285714286,71.42857142857143,-24.10723205801108,-23.72794711091842,0.3792849470926578,42.11303157224768,26.132649355365878,32.961079837782265
1490227200,1038.01,1057.41,1013,1025.14,7729,11458.2,7729,11458.2,41.47680791020672,810834,1033835.0285853916,1033835.0285853916,810834,45.52269644169578,7.142857142857143,64.28571428571429,-23.17439551938953,-28.588709452144258,-5.414313932754726,41.47680791020672,23.992191755946987,31.46071666364027
1490313600,1025.13,1030.3,920.1,934.87,18935,12090.95,18935,12090.95,35.8875566286319,791899,1019975.7082587128,1019975.7082587128,791899,46.53783676206313,0,57.142857142857146,-27.086330788226277,-39.27222741803757,-12.185896629811296,35.8875566286319,4.31210351284128,18.145648208051437
1490400000,933.94,973.99,890.05,963.89,13019,12548.15,13019,12548.15,38.74531980309971,804918,1029861.7108796325,1029861.7108796325,804918,47.62459340428277,35.714285714285715,100,-26.15526071251505,-44.87997252045511,-18.72471180794006,38.74531980309971,19.069262951293847,15.791186073360763
1490486400,963.72,1005,943.9,973.08,9450,12788.05,9450,12788.05,39.662540225633364,814368,1029437.9301922348,1029437.9301922348,814368,48.02423239313685,28.571428571428573,92.85714285714286,-23.44338808701038,-48.028946916703035,-24.585558829692655,39.662540225633364,21.442590775269895,14.941319079801731
1490572800,974.24,1045.9,961.1,1042.08,10224,12769.2,10224,12769.2,46.17890291099877,824592,1038740.8056639329,1038740.8056639329,824592,47.63244296946997,21.428571428571427,85.71428571428571,-15.887137070864824,-44.444480168273685,-28.55734309740886,46.17890291099877,39.26191828934455,26.591257338636154
1490659200,1042.28,1069.39,1016.25,1045.39,9001,12572.2,9001,12572.2,46.47752231339783,833593,1039611.4330632555,1039611.4330632555,833593,46.84782407597482,14.285714285714286,78.57142857142857,-9.846607032210535,-40.86560188767203,-31.018994855461493,46.47752231339783,40.11672950777339,33.60707952412934
1490745600,1045.54,1058.16,1005.77,1043.27,8350,12565.95,8350,12565.95,46.30033112401699,825243,1043215.0501657559,1043215.0501657559,825243,46.207362640159566,7.142857142857143,71.42857142857143,-5.396843609321451,-37.765049367113306,-32.368205757791856,46.30033112401699,39.569237126181505,39.64929497443321
1490832000,1043.09,1052.94,1022,1042.34,8282,11719.25,8282,11719.25,46.21709084420714,816961,1045822.2473215412,1045822.2473215412,816961,45.61264844975969,0,64.28571428571429,-2.08916231623882,-34.97965865309038,-32.89049633685156,46.21709084420714,53.42384059496246,44.36993574297251
1490918400,1042.33,1094.49,1038.11,1088.99,11247,11768.65,11247,11768.65,50.97803945177905,828208,1054874.9053563052,1054874.9053563052,828208,44.25108803083727,0,57.142857142857146,3.370495972578631,-28.677376371128275,-32.047872343706906,50.97803945177905,86.51445966514461,59.835845795429584
1491004800,1088.99,1110.95,1071.45,1092,6713,11769.6,6713,11769.6,51.27773219642064,834921,1055146.8243436469,1055146.8243436469,834921,42.68061276215862,21.428571428571427,50,7.100082551337351,-23.172769154535217,-30.27285170587257,51.27773219642064,87.8234398782344,75.92058004611388
1491091200,1092,1119,1080,1113.99,7868,11714.55,7868,11714.55,53.513643043451324,842789,1060993.3535744161,1060993.3535744161,842789,41.06925199299831,14.285714285714286,42.857142857142854,10.744859342907262,-16.84177752723849,-27.586636870145753,53.513643043451324,97.38638834529247,90.57476262955721
1491177600,1113.23,1168.72,1112.24,1152.44,12655,11976.6,12655,11976.6,57.21118449029921,855444,1066352.9073987787,1066352.9073987787,855444,38.677169996870504,100,35.714285714285715,15.17136281931862,-8.622433345997479,-23.7937961653161,57.21118449029921,94.15796461764813,93.12259761372506
1491264000,1152.09,1164.14,1124.98,1143.99,8550,12043.45,8550,12043.45,56.15408959200436,846894,1066104.005458023,1066104.005458023,846894,36.45595100046611,92.85714285714286,28.571428571428573,16.828165772777393,-2.7585889493443574,-19.58675472212175,56.15408959200436,91.12570423798759,94.22335240030947
1491350400,1143.98,1144.99,1114.9,1132.99,8684,11652.65,8684,11652.65,54.73624478761315,838210,1067861.5847202362,1067861.5847202362,838210,34.551562913523206,85.71428571428571,21.428571428571427,16.461031911388883,0.9895351671143544,-15.471496744274528,54.73624478761315,87.17838303369577,90.82068396311057
1491436800,1132.99,1206.97,1132.98,1192.3,11212,11256.15,11212,11256.15,60.52388625285923,849422,1074627.5774219527,1074627.5774219527,849422,32.45788958759491,100,14.285714285714286,19.294081349869245,8.646104943062028,-10.647976406807217,60.52388625285923,95.37107156380156,91.22505294516172
1491523200,1192.29,1203,1175.26,1193.99,6955,10408.85,6955,10408.85,60.67817284687843,856377,1077064.5853527386,1077064.5853527386,856377,30.513764356375773,92.85714285714286,7.142857142857143,20.26328164653554,14.681125651362208,-5.5821559951733315,60.67817284687843,95.90432916824436,92.81792792191396
1491609600,1194,1198,1170,1184.5,4391,9953.85,4391,9953.85,59.277149720397425,851986,1077221.40678131,1077221.40678131,851986,28.608538482864144,85.71428571428571,0,19.253784729598074,18.48507491682426,-0.768709812773813,59.277149720397425,91.45854715474968,94.2446492955986
1491696000,1184.5,1221,1175.8,1210.97,5792,9799.5,5792,9799.5,61.918347977139014,857778,1080442.8864273278,1080442.8864273278,857778,27.24417516745763,100,0,19.307998150253347,23.36628787504287,4.058289724789525,61.918347977139014,96.14082339361293,94.50123323886906
1491782400,1210.99,1219.78,1201,1210,5435,9449.45,5435,9449.45,61.76026886475938,852343,1080217.1516030466,1080217.1516030466,852343,25.977266374580154,92.85714285714286,0,18.230919117376327,26.846938621509935,8.616019504133607,61.76026886475938,94.8891883101798,94.16285295284753
1491868800,1210,1234,1200,1223.99,5424,8995.8,5424,8995.8,63.21878701884381,857767,1082447.3727795172,1082447.3727795172,857767,25.062911449680698,100,7.142857142857143,17.41439045240225,30.384007569636424,12.969617117234172,63.21878701884381,95.61407352232398,95.54802840870563
1491955200,1224,1227.86,1209.61,1214.17,6458,8932.25,6458,8932.25,61.44714023076487,851309,1079216.6034644488,1079216.6034644488,851309,24.21386759084549,92.85714285714286,0,15.244783998289229,32.02559711509571,16.780813116806478,61.44714023076487,90.64622641509438,93.71649608253279
1492041600,1214.68,1219.49,1148.98,1177.05,9408,8455.9,9408,8455.9,55.15501766707582,841901,1077299.24479192,1077299.24479192,841901,22.893179433637957,85.71428571428571,0,10.563860786189075,29.985639099542823,19.421778313353748,55.15501766707582,70.92756138649241,85.72928710797032
1492128000,1177.05,1196.92,1170.14,1173.74,5643,8087.1,5643,8087.1,54.617941922702556,836258,1073173.4068531597,1073173.4068531597,836258,21.666826144802396,78.57142857142857,0,6.6878726502042305,27.781619126109035,21.093746475904805,54.617941922702556,62.92832974469393,74.83403918209363
1492214400,1173.13,1190.99,900,1178.85,3947,7811.95,3947,7811.95,55.34094087813446,840205,1076791.0719619263,1076791.0719619263,840205,23.64737848141428,71.42857142857143,100,4.041689643357238,26.14585853010135,22.104168886744112,55.34094087813446,83.48802395209579,72.44797169442744
1492300800,1178.84,1189.93,1171.7,1177.99,3058,7453.65,3058,7453.65,55.181606292471066,837147,1075843.3100310431,1075843.3100310431,837147,25.486462793982454,64.28571428571429,92.85714285714286,1.9148386707599414,24.497717225194037,22.582878554434096,55.181606292471066,83.23053892215569,76.5489642063152
1492387200,1177.63,1197.6,1170.85,1189.91,6557,7331.45,6557,7331.45,57.02835573335756,843704,1078630.3414329123,1078630.3414329123,843704,27.03386141410124,57.142857142857146,85.71428571428571,1.036213437461953,23.878145351261537,22.841931913799584,57.02835573335756,86.79940119760481,84.50598802395216
1492473600,1190.95,1206.65,1189.76,1201.94,6247,7226.3,6247,7226.3,58.870319488307786,849951,1081393.2242037826,1081393.2242037826,849951,28.27383181667131,50,78.57142857142857,0.9906691049859759,24.080268295032056,23.08959919004608,58.870319488307786,90.40119760479044,86.81037924151703
1492560000,1201.88,1215.32,1191.09,1214.21,6249,7124.65,6249,7124.65,60.719745737741796,856200,1087069.6785991604,1087069.6785991604,856200,29.22967568743511,42.857142857142854,71.42857142857143,1.4827295548875732,24.943011133655546,23.460281578767972,60.719745737741796,94.0748502994012,90.42514970059888
1492646400,1214.22,1240.6,1212.01,1236.15,7718,6948.2,7718,6948.2,63.84991450684335,863918,1092385.083286114,1092385.083286114,863918,29.548672020282226,100,64.28571428571429,2.899693013908486,27.08489784615358,24.185204832245095,63.84991450684335,98.6934820904287,94.38984333154018
1492732800,1236.15,1258.77,1236.15,1249.99,6663,6945.7,6663,6945.7,65.70639647985419,870581,1093875.5686972546,1093875.5686972546,870581,29.446829316855982,100,57.142857142857146,4.298556130904192,29.558399995875334,25.259843864971142,65.70639647985419,97.55274967249213,96.77369402077409
1492819200,1249.98,1253,1221.51,1247,6116,6858.1,6116,6858.1,64.9305950560827,864465,1097660.9240481597,1097660.9240481597,864465,29.53146841383813,92.85714285714286,50,4.528895027093657,30.920962648838213,26.392067621744555,64.9305950560827,96.71934665663238,97.65519280651779
1492905600,1246.79,1254,1236.2,1251.98,4996,6475.15,4996,6475.15,65.65789355326626,869461,1101523.0004526542,1101523.0004526542,869461,29.586164838265056,85.71428571428571,42.857142857142854,4.513055346961394,32.0333868054463,27.520331458484904,65.65789355326626,98.10742258271317,97.45983963727929
1492992000,1251.91,1261.16,1246.31,1257.29,5901,6342.7,5901,6342.7,66.45669709007296,875362,1104348.3277253814,1104348.3277253814,875362,29.45672109026133,100,35.714285714285715,4.354519709695488,32.963481095604266,28.608961385908778,66.45669709007296,98.92845276331818,97.9184073342213
1493078400,1256.65,1287,1256.16,1281.16,8103,6313.65,8103,6313.65,69.8515475913819,883465,1109382.4872584553,1109382.4872584553,883465,28.69768507042546,100,28.571428571428573,5.289386720260126,35.220694786233935,29.93130806597381,69.8515475913819,98.49095607235144,98.50894380612766
1493164800,1281.18,1320,1279.5,1298.44,9598,6232.95,9598,6232.95,72.05637019061378,893063,1108761.5796041342,1108761.5796041342,893063,27.24750814052838,100,21.428571428571427,6.427956067440551,37.9662531502745,31.538297082833946,72.05637019061378,94.86666666666669,97.42869183411216
1493251200,1297.56,1360,1295.39,1349.26,10467,6408.55,10467,6408.55,77.31156455093384,903530,1115748.7597620045,1115748.7597620045,903530,25.497847467339906,100,14.285714285714286,9.760310238590812,43.73868488107246,33.97837464248165,77.31156455093384,97.66521739130435,97.00761337677422
1493337600,1349.77,1381.01,1300.2,1353.34,14005,6889.25,14005,6889.25,77.67457233372411,917535,1120162.9083822246,1120162.9083822246,917535,24.25502936580223,100,7.142857142857143,11.287915396445712,48.08826888803878,36.80035349159307,77.67457233372411,94.24752084156253,95.59313496651124
1493424000,1352.96,1369.5,1335.64,1365.43,9671,7083.2,9671,7083.2,78.75908690318806,927206,1127508.9839876588,1127508.9839876588,927206,23.10098398580296,92.85714285714286,0,12.089711294623193,51.91249260987206,39.82278131524887,78.75908690318806,92.58660068519227,94.83311297268644
1493510400,1364.98,1394.51,1334.02,1384.55,10513,7337.1,10513,7337.1,80.38214268363036,937719,1134559.9413359808,1134559.9413359808,937719,22.49243579095528,100,7.142857142857143,12.815635823310394,55.84232609438686,43.02669027107647,80.38214268363036,95.54681212554769,94.1269778841009
1493596800,1384.55,1466.69,1370.98,1436.5,16963,7914.05,16963,7914.05,83.96690237759296,954682,1140821.5941413303,1140821.5941413303,954682,23.024510430392407,100,0,15.521875960902562,62.429035222204675,46.90715926130211,83.96690237759296,89.0983280973531,92.41058030269774
1493683200,1436.5,1492.93,1426.51,1471.99,11955,8188.9,11955,8188.9,85.86689221582076,966637,1145238.5724611136,1145238.5724611136,966637,23.847705189900633,100,0,18.24165773569886,69.70923143092568,51.467573695226825,85.86689221582076,93.06254969520273,92.56922997270124
1493769600,1471.79,1533,1453.68,1533,16312,8534.1,16312,8534.1,88.4096745291839,982949,1161550.5724611136,1161550.5724611136,982949,25.068402721418558,100,0,22.414402044227543,79.48557625051126,57.071174206283715,88.4096745291839,100,94.053625930852
1493856000,1533,1665,1482.06,1563.39,25830,9543.45,25830,9543.45,89.42983316750255,1008779,1158687.1615067024,1158687.1615067024,1008779,27.286982259247583,100,0,25.27390914622889,88.66356063906983,63.38965149284094,89.42983316750255,77.08854765609149,90.0503657837648
1493942400,1561.47,1630,1535.11,1551.3,16673,10179.75,16673,10179.75,86.18001595909172,992106,1147703.609709885,1147703.609709885,992106,29.34709183008882,92.85714285714286,7.142857142857143,24.391825811108077,93.87943375672603,69.48760794561795,86.18001595909172,74.36244334708788,83.81699700105985
1494028800,1551.3,1598.89,1551.3,1585.39,9348,10494.25,9348,10494.25,87.55345876664671,1001454,1151748.0585436735,1151748.0585436735,1001454,31.260050717298547,85.71428571428571,0,24.10233215276901,99.61552313657921,75.5131909838102,87.55345876664671,81.4342350746269,77.62840869260215
1494115200,1585.49,1618.31,1563.87,1609.57,11729,10752.85,11729,10752.85,88.43164875741356,1013183,1159711.0240102422,1159711.0240102422,1013183,33.177787535114675,78.57142857142857,0,23.512070820593095,104.90327950955157,81.39120868895847,88.43164875741356,86.76108815591486,80.85258885920994
1494201600,1611.1,1713,1608,1713,15896,11235.3,15896,11235.3,91.26932347070417,1029079,1175607.0240102422,1175607.0240102422,1029079,35.53177505666635,100,0,27.76819770383456,116.10145581875167,88.33325811491711,91.26932347070417,100,89.3984410768473
1494288000,1712.99,1794.7,1630,1720.43,19867,11916.2,19867,11916.2,91.43191645736925,1048946,1177556.3301426042,1177556.3301426042,1048946,38.08315411291234,100,0,28.64904856023017,124.14456881520482,95.49552025497465,91.43191645736925,85.5842391304348,90.78177576211662
1494374400,1720.24,1799.99,1691.3,1794.99,13444,12202.5,13444,12202.5,92.86741466888937,1062390,1189763.4178231636,1189763.4178231636,1062390,40.47370325562621,100,0,31.586948930836726,134.97920641852056,103.39225748768384,92.86741466888937,99.00911613158938,94.86445175400813
1494460800,1794.95,1889,1770.95,1837.93,15723,12655.5,15723,12655.5,93.53880157351712,1078113,1191882.4600086783,1191882.4600086783,1078113,43.016424414594574,100,0,33.57025091729096,145.35507113429753,111.78482021700657,93.53880157351712,91.3264266304348,91.97326063081971
1494547200,1837.98,1838,1651.01,1695.61,15908,13145.1,15908,13145.1,70.01507889315371,1062205,1183563.0668860513,1183563.0668860513,1062205,43.02077216523036,92.85714285714286,0,22.951887371556836,140.4746794314526,117.52279205989578,70.01507889315371,65.15369923240476,85.1630806648097
1494633600,1695.56,1792.96,1610,1792.73,12375,13514.05,12375,13514.05,74.69235861412491,1074580,1195906.9535279402,1195906.9535279402,1074580,42.36513991848723,85.71428571428571,7.142857142857143,20.219865598651353,142.79762405820998,122.57775845955862,74.69235861412491,82.65342895239468,79.71118493841146
1494720000,1791.7,1829,1763.33,1799.99,6783,13558.15,6783,13558.15,75.00621794292624,1081363,1196697.115702449,1196697.115702449,1081363,42.02839961806376,78.57142857142857,0,16.79332672650041,143.56941686768414,126.77609014118373,75.00621794292624,82.81726574263543,76.87479797581169
1494806400,1799.98,1802.99,1702.42,1747.81,10168,13661.4,10168,13661.4,68.43682333374011,1071195,1195707.3103927146,1195707.3103927146,1071195,40.78316070256193,71.42857142857143,0,9.279505495467447,138.37547201051802,129.09596651505058,68.43682333374011,69.47177236264567,78.31415568589198
1494892800,1747.81,1777.76,1690.14,1777.48,11410,13752,11410,13752,70.04346075048588,1082605,1207044.3864027578,1207044.3864027578,1082605,39.44729613917248,64.28571428571429,0,4.800067704037076,135.0960511450969,130.29598344105983,70.04346075048588,74.3820637691813,75.55703395815418
1494979200,1777.49,1840,1745.05,1813.23,13806,13918.95,13806,13918.95,71.89952904674347,1096411,1213065.5181563124,1213065.5181563124,1096411,38.75900390089465,57.142857142857146,0,2.8344132684806596,133.83900002666064,131.00458675817998,71.89952904674347,81.38054750086009,75.07812787756241
1495065600,1813.23,1900,1800,1899.16,11392,13788.3,11392,13788.3,75.78343189674126,1107803,1224266.1325563125,1224266.1325563125,1107803,38.58801758467418,100,0,5.743302563099917,138.18371496205486,132.44041239895495,75.78343189674126,99.7697936364384,85.17746830215998
1495152000,1899.47,1980,1890.73,1976.23,18954,14252.45,18954,14252.45,78.63557434468848,1126757,1241619.2234043018,1241619.2234043018,1126757,38.96662858676692,100,0,10.976457998936212,146.1609848976252,135.184526898689,78.63557434468848,99.12059715418708,93.42364609716189
1495238400,1976.22,2059,1970.04,2058.91,13164,14385,13164,14385,81.19442544464843,1139921,1254756.5876129349,1254756.5876129349,1139921,39.76583584915328,100,0,17.725087294171857,157.34088601640383,139.61579872223197,81.19442544464843,99.9818229555874,99.62407124873766
1495324800,2058.89,2102.68,1988.6,2057,17706,14422.15,17706,14422.15,80.95320981266822,1122215,1258282.8877531874,1258282.8877531874,1122215,40.72996676231642,100,0,19.631076703938078,164.15464460215458,144.5235678982165,80.95320981266822,90.76574755397432,96.62272255458298
1495411200,2056.99,2298,1975,2123.29,29427,15295.75,29427,15295.75,82.8567881861135,1151642,1255875.886700556,1255875.886700556,1151642,42.39617106234257,100,0,22.709499614256657,172.9104424160373,150.20094280178066,82.8567881861135,74.6061046511628,88.45122505357487
1495497600,2123.29,2283,2100.86,2272.75,17629,15361.6,17629,15361.6,86.20449992095882,1169271,1271520.7289098455,1271520.7289098455,1169271,43.9433607695097,92.85714285714286,28.571428571428573,31.617360669533298,189.72264363869726,158.10528296916397,86.20449992095882,96.32994186046511,87.23393135520077
1495584000,2272.74,2474.69,2266.51,2432.97,24653,15302.75,24653,15302.75,88.74241712227857,1193924,1286292.6340880566,1286292.6340880566,1193924,45.91441787923088,100,21.428571428571427,44.32665152520326,213.51359737566804,169.18694585046478,88.74241712227857,95.17514947553457,88.70373199572084
1495670400,2432.96,2806,2253.15,2355,30856,16011.9,30856,16011.9,80.93886064141563,1163068,1266805.662215035,1266805.662215035,1163068,48.31237259349143,100,14.285714285714286,43.45060415614935,223.50020104565147,180.0495968895021,80.93886064141563,62.290969899665555,84.5986870785551
1495756800,2362.17,2683.18,2052.01,2272.7,31763,17132.65,31763,17132.65,73.5835803965778,1131305,1257254.669978395,1257254.669978395,1131305,48.559802028378265,92.85714285714286,7.142857142857143,33.73009062990633,222.21221017688504,188.4821195469787,73.5835803965778,55.40969899665551,70.9586061239519
1495843200,2276.46,2353.35,1913.19,2099.99,32475,18169.95,32475,18169.95,61.046288555927404,1098830,1252343.8739042403,1252343.8739042403,1098830,47.67363088152509,85.71428571428571,0,13.128969758355964,204.89333174492367,191.7643619865677,61.046288555927404,36.72951803989746,51.47672897873952
1495929600,2099.99,2342.99,2099.86,2232.78,18318,18291.05,18318,18291.05,65.8623207686255,1117148,1254054.9000219551,1254054.9000219551,1117148,46.850757673732865,78.57142857142857,14.285714285714286,6.254412511484645,199.58237762592353,193.32796511443888,65.8623207686255,48.62975642105641,46.922991152536476
1496016000,2237,2357.86,2141.12,2279.48,16908,18143.1,16908,18143.1,67.38931250892077,1134056,1258733.970982553,1258733.970982553,1134056,46.14424213247556,71.42857142857143,7.142857142857143,2.8354573180683076,196.87228676202426,194.03682944395595,67.38931250892077,52.8148692488305,46.058047903261475
1496102400,2279.18,2336.88,2112.31,2191.58,20929,18517.35,20929,18517.35,61.78712832027294,1113127,1252580.2466649683,1252580.2466649683,1113127,45.23708561942058,64.28571428571429,0,-6.834686304224562,185.49347156367526,192.32815786789982,61.78712832027294,42.087751543428055,47.844125737771684
1496188800,2191.6,2338.91,2173.8,2303.29,21724,18817.4,21724,18817.4,65.69073160753823,1134851,1264930.9939243712,1264930.9939243712,1134851,44.40396754787693,57.142857142857146,0,-7.161807313010684,183.37589872663648,190.53770603964716,65.69073160753823,50.02882703777336,48.31048261001066
1496275200,2303.61,2488,2302,2419.99,21388,19091.4,21388,19091.4,69.22732211982637,1156239,1270678.1565050164,1270678.1565050164,1156239,44.26265915041289,50,0,-1.2809811782540805,188.93647956682958,190.21746074508366,69.22732211982637,57.82555967091675,49.98071275070608
1496361600,2419.98,2478.99,2379.44,2478.99,12886,19116.95,12886,19116.95,70.86259427045036,1169125,1283564.1565050164,1283564.1565050164,1169125,44.131444209910555,42.857142857142854,0,4.503223747506638,195.84649042946694,191.3432666819603,70.86259427045036,63.37294609155361,57.07577760008127
1496448000,2478.99,2599,2448,2548.05,13443,19449.95,13443,19449.95,72.69185730802391,1182568,1287935.3571672682,1287935.3571672682,1182568,44.46461664727606,35.714285714285715,50,10.55539273135551,204.53750759615468,193.98211486479917,72.69185730802391,71.10807450633395,64.1021934229348
1496534400,2548.3,2556.1,2469.98,2521.36,13801,19631.6,13801,19631.6,70.84081847049318,1168767,1290601.9693363346,1290601.9693363346,1168767,44.773991053401176,28.571428571428573,42.857142857142854,10.323652510906811,206.88668050343267,196.56302799252586,70.84081847049318,68.11863666401587,67.53321908730116
1496620800,2521.43,2698,2517.02,2698,13588,19740.5,13588,19740.5,75.32001242154232,1182355,1304189.9693363346,1304189.9693363346,1182355,45.543089643664246,21.428571428571427,35.714285714285715,19.117943837757366,220.46045778972257,201.3425139519652,75.32001242154232,87.90336129747651,75.71002415594212
1496707200,2698,2938.55,2674.69,2871.29,28610,20480.7,28610,20480.7,78.7660803713895,1210965,1318214.1389717474,1318214.1389717474,1210965,46.8729230891653,100,28.571428571428573,32.85120275697682,242.40651739818622,209.5553146412094,78.7660803713895,93.4403526566279,83.15411687270678
1496793600,2871.29,2885,2598.7,2685.64,19474,20884.8,19474,20884.8,67.83769246924396,1191491,1310567.380047542,1310567.380047542,1191491,47.382234065704125,92.85714285714286,21.428571428571427,25.97860396680045,242.02856959970995,216.0499656329095,67.83769246924396,75.33451665756415,85.55941020388953
1496880000,2690.02,2808.78,2611.41,2799.73,13453,20609.75,13453,20609.75,70.54257813234506,1204944,1322786.6601306347,1322786.6601306347,1204944,47.855165686775905,85.71428571428571,14.285714285714286,25.62042181052334,248.07549289606368,222.45507108554034,70.54257813234506,86.46134040727158,85.07873657382123
1496966400,2799.76,2861.58,2786.2,2811.39,11449,20524,11449,20524,70.81274409407652,1216393,1318989.5654105498,1318989.5654105498,1216393,48.45035450649832,78.57142857142857,7.142857142857143,22.768888867023804,250.9161821693201,228.1472933022963,70.81274409407652,87.59850198954511,83.13145301812698
1497052800,2811.37,2942.04,2801.25,2931.15,18739,20575.65,18739,20575.65,73.50095894008403,1235132,1334829.6704606244,1334829.6704606244,1235132,49.229303805307055,100,0,25.3508485784468,259.8358540253548,234.48500544690802,73.50095894008403,98.70692726020567,90.92225655234081
1497139200,2931.16,2998.99,2881,2998.98,16308,19919.7,16308,19919.7,74.9104376128204,1251440,1351134.9061585648,1351134.9061585648,1251440,50.1042625509361,100,0,27.831234633260408,269.27404873848354,241.44281410522314,74.9104376128204,99.99887219741058,95.43476714905383
1497225600,2998.98,2999.99,2463.89,2655.71,38946,20985.55,38946,20985.55,58.075244155039236,1212494,1340059.1606633214,1340059.1606633214,1212494,47.55116350819091,100,7.142857142857143,3.8190557434321306,246.2166337845133,242.39757804108118,58.075244155039236,61.21575342465756,86.64051762742463
1497312000,2654.36,2798.99,2649.47,2709.01,17617,20633.75,17617,20633.75,59.59369574038977,1230111,1336472.6071587736,1336472.6071587736,1230111,45.180428682784665,92.85714285714286,0,-10.2399249721596,229.59767182588166,239.83759679804126,59.59369574038977,64.78049843256397,75.33170801821073
1497398400,2709.02,2827,2330,2432.21,28258,20503.85,28258,20503.85,49.55568893971856,1201853,1319837.3443016307,1319837.3443016307,1201853,42.608901472477825,85.71428571428571,0,-38.36631086303228,191.87970821925092,230.2460190822832,49.55568893971856,18.654995057235787,48.21708230481914
1497484800,2432.21,2525,2050,2409.98,42029,21017.15,42029,21017.15,48.84411913858036,1159824,1341511.9208068938,1341511.9208068938,1159824,41.27638917907229,78.57142857142857,100,-57.501934900569296,158.36860045657158,215.87053535714088,48.84411913858036,37.89303045295215,40.442841314250664
1497571200,2409.98,2524.65,2287.84,2480.43,21887,20487.75,21887,20487.75,51.233953267009674,1181711,1355224.915148349,1355224.915148349,1181711,40.039056335195724,71.42857142857143,92.85714285714286,-63.953522932564766,135.92863169143493,199.8821546239997,51.233953267009674,45.30889798839987,33.95230783286263
1497657600,2480.44,2679.24,2413.96,2634.94,17604,20452.05,17604,20452.05,56.08007239306713,1199315,1366949.4127358038,1366949.4127358038,1199315,38.05484357843834,64.28571428571429,85.71428571428571,-56.606524185774845,129.12399939178113,185.73052357755597,56.08007239306713,61.5732797187339,48.25840272002866
1497744000,2634.94,2670,2455.01,2515.25,13843,20298.8,13843,20298.8,51.78686275884854,1185472,1360864.0044377435,1360864.0044377435,1185472,36.21236030430648,57.142857142857146,78.57142857142857,-58.365766083598515,112.77331597305783,171.13908205665635,51.78686275884854,48.974199728418206,51.952125811850685
1497830400,2515.25,2597,2481.92,2596.98,13926,19948.65,13926,19948.65,54.35643819694716,1199398,1374785.1639789322,1374785.1639789322,1199398,34.5014829783269,50,71.42857142857143,-52.75321959973601,105.19755755698634,157.95077715672235,54.35643819694716,57.577448183665105,56.04164254360577
1497916800,2596.99,2776.95,2585.42,2725.08,19214,19823.15,19214,19823.15,58.12362673994991,1218612,1383592.1240374087,1383592.1240374087,1218612,32.128518040549515,42.857142857142854,64.28571428571429,-39.734937604911494,108.28210515058299,148.0170427554945,58.12362673994991,71.06180065053319,59.20448285420553
1498003200,2725.11,2781.59,2559.51,2643.35,18053,19656.4,18053,19656.4,55.0043635123415,1200559,1379169.9194264577,1379169.9194264577,1200559,29.875011076130203,35.714285714285715,57.142857142857146,-36.057620357122175,102.94501730909178,139.00263766621396,55.0043635123415,62.45855219528627,63.69926700982822
1498089600,2643.33,2724.69,2598,2679.99,12166,19620.4,12166,19620.4,56.14073242585881,1212725,1382750.8661467987,1382750.8661467987,1212725,27.782468894883706,28.571428571428573,50,-30.791530418224966,100.51322464343275,131.30475506165772,56.14073242585881,66.31543489931472,66.61192924837809
1498176000,2679.93,2743,2665,2690.76,9675,19432,9675,19432,56.4885864717376,1222400,1379466.3276852602,1379466.3276852602,1222400,25.86311566244877,21.428571428571427,42.857142857142854,-26.386468509235243,98.32166942511367,124.70813793434891,56.4885864717376,67.44913104348471,65.4077060460286
1498262400,2690.76,2718.37,2503.05,2574.84,12782,19381.05,12782,19381.05,51.73273306462622,1209618,1375207.6397788883,1375207.6397788883,1209618,24.84246951855773,14.285714285714286,35.714285714285715,-30.77692264268873,86.23698463098799,117.01390727367672,51.73273306462622,55.24689733576146,63.003821092853656
1498348800,2574.86,2625,2430.05,2505.61,13721,19387.7,13721,19387.7,49.07536371381447,1195897,1372122.790176426,1372122.790176426,1195897,24.25258869784537,7.142857142857143,28.571428571428573,-37.40028741764634,70.2635480016188,107.66383541926514,49.07536371381447,47.959452204760076,56.88516019466878
1498435200,2505.61,2563.9,2258.34,2407.91,20252,18969.8,20252,18969.8,45.52159708644264,1175645,1371697.2834347058,1371697.2834347058,1175645,24.45266232973315,0,21.428571428571427,-46.807635666499905,49.15429083614026,95.96192650264017,45.52159708644264,46.06306306306305,49.75647086786156
1498521600,2407.91,2575.75,2264,2575.75,22151,19103.65,22151,19103.65,51.95785394217427,1197796,1393848.2834347058,1393848.2834347058,1197796,24.554574203446112,7.142857142857143,14.285714285714286,-40.413955561920574,45.44448205023946,85.85843761216003,51.95785394217427,67.66409266409266,53.89553597730529
1498608000,2573.22,2605,2457,2553.12,16249,19243.45,16249,19243.45,51.08156573481163,1181547,1398705.4169482193,1398705.4169482193,1181547,24.433615739047156,0,7.142857142857143,-36.51490312605763,40.214808704587995,76.72971183064563,51.08156573481163,68.77075957845238,60.83263843520273
1498694400,2553.13,2591.98,2506.1,2530,9034,19122.7,9034,19122.7,50.150965789740766,1172513,1394699.6563520385,1394699.6563520385,1172513,24.32129716496241,42.857142857142854,0,-34.3318755603847,33.81486738016474,68.14674294054944,50.150965789740766,51.91782130912563,62.784224517223585
1498780800,2531.16,2554.01,2446.2,2455.19,11846,18778.05,11846,18778.05,47.157293859513736,1160667,1384829.2716010879,1384829.2716010879,1160667,24.513870971088014,35.714285714285715,71.42857142857143,-36.559342804403535,22.447564435045024,59.00690723944856,47.157293859513736,37.62064022933587,52.76974037230465
1498867200,2455.19,2515,2400,2423.63,8453,18385.3,8453,18385.3,45.91216388144416,1152214,1379850.0870793487,1379850.0870793487,1152214,24.915994615077565,28.571428571428573,64.28571428571429,-38.591015138447275,10.768138316389468,49.35915345483674,45.91216388144416,31.58910654562828,40.37585602802995
1498953600,2424.08,2545,2385,2516.66,9098,16892.9,9098,16892.9,50.095086508321074,1161312,1385725.1205793486,1385725.1205793486,1161312,25.019032049686903,21.428571428571427,57.142857142857146,-32.35446393046362,8.916073541757214,41.27053747222084,50.095086508321074,49.36837075967505,39.52603917821309
1499040000,2515.37,2584.78,2479.75,2542.41,10018,16512.95,10018,16512.95,51.21959951131363,1171330,1387660.4268727885,1387660.4268727885,1171330,24.754807238099165,14.285714285714286,50,-25.48239076189998,9.417549019845865,34.89993978174584,51.21959951131363,54.28953655040606,45.082337951903156
1499126400,2542.41,2636.1,2542.18,2602,10676,15633.85,10676,15633.85,53.81329502106117,1182006,1390584.0503821583,1390584.0503821583,1182006,24.0545708147597,7.142857142857143,42.857142857142854,-16.35456090491589,14.456738650600983,30.81129955551687,53.81329502106117,65.6779741997133,56.44529383659816
1499212800,2602,2630.24,2551.06,2616.96,10168,14040.8,10168,14040.8,54.46783298366627,1192174,1397341.3143377027,1397341.3143377027,1192174,23.40435127880162,0,35.714285714285715,-9.10226936471867,19.433462849618536,28.535732214337205,54.46783298366627,73.9941402220113,64.65388365737691
1499299200,2616.96,2623.54,2580.69,2604.84,8201,13356.5,8201,13356.5,53.80259537185457,1183973,1398384.382015649,1398384.382015649,1183973,22.80057599541198,7.142857142857143,28.571428571428573,-5.113142435748845,22.14430416965115,27.257446605399995,53.80259537185457,71.49341806627328,70.38851082933265
1499385600,2604.89,2607.61,2472,2501.15,11625,13057.55,11625,13057.55,48.360722215661696,1172348,1391757.0776133188,1391757.0776133188,1172348,22.98059885429261,0,21.428571428571427,-9.210550082319063,15.744259002501167,24.95480908482023,48.360722215661696,52.78134034736866,66.0896328785511
1499472000,2501.15,2563.5,2471.22,2561.11,7859,12758.35,7859,12758.35,51.42061781494652,1180207,1399208.9902704493,1399208.9902704493,1180207,23.15278449724209,0,14.285714285714286,-7.696894668650206,15.333690749007474,23.03058541765768,51.42061781494652,80.1487717069039,68.14117670684863
1499558400,2560.84,2579.84,2500,2508.99,5615,12342.8,5615,12342.8,48.718243306214696,1174592,1394858.4905209502,1394858.4905209502,1174592,23.126410208224186,64.28571428571429,7.142857142857143,-9.880822931972581,10.679556752691951,20.560379684664532,48.718243306214696,66.3516518424396,66.4272546322374
1499644800,2508,2523,2250,2331.05,15527,12158.45,15527,12158.45,40.829068493700746,1159065,1388551.002242562,1388551.002242562,1159065,24.509500361576066,57.142857142857146,100,-22.274857948991194,-7.283192751574461,14.991665197416733,40.829068493700746,20.991970991971044,55.830798180438194
1499731200,2330.93,2410,2265,2310.01,15560,12033.8,15560,12033.8,40.004167123404855,1143505,1382651.0794839412,1382651.0794839412,1143505,25.793798361117094,50,92.85714285714286,-30.354913920827297,-22.95197720361739,7.402936717209908,40.004167123404855,15.542605542605603,34.295409459005434
1499817600,2309.62,2415,2250,2383.42,13833,12117.15,13833,12117.15,44.237378076169215,1157338,1391188.9747566686,1391188.9747566686,1157338,27.0580386473884,42.857142857142854,85.71428571428571,-29.21071818053037,-29.110461008453058,0.10025717207731333,44.237378076169215,34.555814555814585,23.696797030130437
1499904000,2384.35,2416.79,2308.14,2340,9539,12110.35,9539,12110.35,42.334703038017516,1147799,1387244.3151156192,1387244.3151156192,1147799,28.209043943412382,35.714285714285715,78.57142857142857,-29.734161330284003,-37.06744449077769,-7.3332831604936874,42.334703038017516,23.310023310023315,24.469481136147852
1499990400,2340,2349.28,2150,2217.24,13531,12147.8,13531,12147.8,37.432654454790466,1134268,1382844.431534728,1382844.431534728,1134268,29.99025036047918,28.571428571428573,100,-36.27093175294777,-52.6719478516784,-16.40101609873063,37.432654454790466,13.832544743879819,23.899460869905926
1500076800,2217.02,2224.82,1964.31,1964.31,16350,12279.25,16350,12279.25,29.781095758957022,1117918,1366494.431534728,1366494.431534728,1117918,32.25208504008518,21.428571428571427,100,-54.45854741453135,-84.47420036689482,-30.015652952363467,29.781095758957022,0,12.38085601796773
1500163200,1964.33,2043.94,1758.2,1911.78,21736,12353.45,21736,12353.45,28.47907786748918,1096182,1368123.8328086133,1368123.8328086133,1096182,34.84092052128022,14.285714285714286,100,-66.08208041645,-112.61825347292597,-46.536173056475974,28.47907786748918,17.494019820025056,10.442188187968311
1500249600,1911.79,2238.07,1909.58,2235.19,21446,12318.2,21446,12318.2,44.551944081730355,1117628,1389193.7819090425,1389193.7819090425,1117628,35.400839420497284,7.142857142857143,92.85714285714286,-48.839821803853894,-107.58595031129335,-58.74612850743945,44.551944081730355,54.33306754755668,23.9423624558606
1500336000,2235.14,2393.43,2134.37,2308.15,23755,12693.5,23755,12693.5,47.42256398927719,1141383,1397308.9579300415,1397308.9579300415,1141383,34.73198611550761,0,85.71428571428571,-30.28072998850925,-96.597040993076,-66.31631100456676,47.42256398927719,63.06476767120777,44.963951679596526
1500422400,2307.48,2396,2216,2258.99,18564,13170,18564,13170,45.705564454311784,1122819,1387612.3619300413,1387612.3619300413,1122819,34.0922393899273,0,78.57142857142857,-19.593568089993894,-90.80827111705912,-71.21470302706523,45.705564454311784,57.8720502923706,58.42329517037837
1500508800,2258.99,2957,2258.99,2873.48,36507,14403.05,36507,14403.05,63.49673399786529,1159326,1415382.9121943642,1415382.9121943642,1159326,32.76021869192499,100,71.42857142857143,27.996632252501456,-36.218912711438406,-64.21554496393986,63.49673399786529,93.03303303303304,71.32328366553715
1500595200,2873.45,2880,2608.27,2657.45,23028,15131.8,23028,15131.8,56.48872174346637,1136298,1400690.5176851086,1400690.5176851086,1136298,31.523342329494277,92.85714285714286,64.28571428571429,43.15652907810686,-10.269883616306288,-53.426412694413145,56.48872174346637,75.01251251251249,75.3058652793054
1500681600,2661.05,2869.88,2646.95,2825.27,12220,15287.9,12220,15287.9,60.166660685946766,1148518,1408019.8865452888,1408019.8865452888,1148518,30.374814278665756,85.71428571428571,57.142857142857146,61.59308089354348,23.564938422516207,-38.02814247102727,60.166660685946766,89.01151151151151,85.68568568568571
1500768000,2825.27,2848,2691,2754.28,10174,15295.7,10174,15295.7,57.935723953543096,1138344,1406047.2969911487,1406047.2969911487,1138344,29.30832394575355,78.57142857142857,50,65.73622267947565,44.142135878317276,-21.59408680115836,57.935723953543096,83.08975642308977,82.37126014903795
1500854400,2755.19,2799.2,2726.8,2762.26,8104,15167.1,8104,15167.1,58.12369462921266,1146448,1405881.6351126956,1405881.6351126956,1146448,28.31801149376365,71.42857142857143,42.857142857142854,65.5931963927701,60.39740868980425,-5.195787702965838,58.12369462921266,83.75542208875544,85.28556334111893
1500940800,2761.68,2782.44,2449.69,2564,19203,15618.85,19203,15618.85,51.9164537748672,1127245,1399872.2935950398,1399872.2935950398,1127245,26.75845973547085,64.28571428571429,35.714285714285715,49.459925520824974,56.62911919806538,7.169193677240408,51.9164537748672,67.21721721721723,78.02079857635415
1501027200,2564,2614,2403,2525.99,13010,15859.3,13010,15859.3,50.79643306499516,1114235,1402029.1172917222,1402029.1172917222,1114235,25.532855397237565,57.142857142857146,28.571428571428573,34.26406329524615,49.9992727962981,15.735209501051946,50.79643306499516,64.04654654654652,71.67306195083974
1501113600,2525.98,2686.2,2514.1,2664.99,10030,15779.55,10030,15779.55,54.64948506386761,1124265,1409586.876733907,1409586.876733907,1124265,23.98326427856479,50,21.428571428571427,31.67061279762965,55.32347549808901,23.65286270045936,54.64948506386761,75.64147480814145,68.96841285730176
1501200000,2664.99,2825.11,2655.55,2786.07,17178,16245.5,17178,16245.5,57.752950824266826,1141443,1418854.648849972,1418854.648849972,1141443,22.724492415990515,42.857142857142854,14.285714285714286,35.896266513887674,68.52319584281895,32.626929328931276,57.752950824266826,85.74157490824159,75.14319875430988
1501286400,2786.07,2790.99,2656,2700.21,9869,16458.2,9869,16458.2,54.88468707994466,1131574,1415449.957169107,1415449.957169107,1131574,21.5556328293144,35.714285714285715,7.142857142857143,30.88624469015177,71.23473519162098,40.348490501469215,54.88468707994466,78.57941274607941,79.98748748748751
1501372800,2700.2,2739.98,2500,2723.99,8434,16103.55,8434,16103.55,55.543236536898746,1140008,1422760.0330087603,1422760.0330087603,1140008,20.423278999901516,28.571428571428573,0,27.27668664705933,74.44434881029338,47.16766216323405,55.543236536898746,77.75390960646158,80.69163242026087
1501459200,2723.99,2900,2700,2856.88,11444,15897.75,11444,15897.75,59.133277205983525,1151452,1429269.3802087603,1429269.3802087603,1151452,19.39777544284217,21.428571428571427,0,31.63510738008342,86.71154638833832,55.0764390082549,59.133277205983525,87.8292792628521,81.38753387179771
1501545600,2856.89,2925,2676.01,2732.59,9774,15694.8,9774,15694.8,54.685317595002196,1141678,1423937.4294476856,1423937.4294476856,1141678,18.568899105204295,14.285714285714286,0,24.274497638332157,85.4195610561701,61.14506341783794,54.685317595002196,69.7152496626181,78.43281284397727
1501632000,2731.6,2758.06,2650,2699.9,8417,15638.7,8417,15638.7,53.544523253126364,1133261,1423294.042255385,1423294.042255385,1133261,17.64379880380478,7.142857142857143,0,15.74485347118808,80.82613025682303,65.08127678563496,53.544523253126364,63.16671680921479,73.57041524489502
1501718400,2699.9,2799,2699.89,2787.02,7420,15333.15,7420,15333.15,56.16878847142324,1140681,1428920.2454639412,1428920.2454639412,1140681,17.0078321085212,0,0,14.53972781205492,83.25593655070361,68.71620873864869,56.16878847142324,73.56704980842912,68.81633876008736
1501804800,2787.05,2877.79,2760,2857.34,7715,14901.4,7715,14901.4,58.220335288096614,1148396,1433956.38053483,1433956.38053483,1148396,16.83560640282122,78.57142857142857,35.714285714285715,16.883367399762193,89.82041798835144,72.93705058858924,58.220335288096614,87.03831417624524,74.59069359796308
1501891200,2857.34,3335,2857.34,3243.49,21617,14895.45,21617,14895.45,67.27772913523506,1170013,1447290.6201194718,1447290.6201194718,1170013,18.421823887238457,100,28.571428571428573,41.44549898738789,124.74392432282411,83.29842533543622,67.27772913523506,90.18133047210297,83.59556481892581
1501977600,3243.5,3278.42,3150,3222.22,8654,14255.85,8654,14255.85,66.42353531876583,1161359,1448370.18000111,1448370.18000111,1161359,19.894740122768752,92.85714285714286,21.428571428571427,52.551108123673416,148.987310490028,96.43620236635458,66.42353531876583,87.89914163090127,88.37292875974985
1502064000,3222.22,3416,3190,3398.23,11313,13633.75,11313,13633.75,69.83642640002273,1172672,1457904.135664827,1457904.135664827,1172672,21.657895337177287,100,14.285714285714286,67.11042941408613,180.32423913396224,113.21380971987611,69.83642640002273,98.24580454096743,92.10875888132392
1502150400,3398.23,3489,3349.91,3422.43,15993,13505.2,15993,13505.2,70.28367122374686,1188665,1458588.285136392,1458588.285136392,1188665,23.49041733059481,100,7.142857142857143,73.23012910516348,204.75147110133048,131.521341996167,70.28367122374686,93.87016574585634,93.33837063924172
1502236800,3423.28,3428.29,3232.62,3342.8,13093,12334.5,13093,12334.5,66.77515516250303,1175572,1460240.3839251692,1460240.3839251692,1175572,24.364428274339687,92.85714285714286,0,66.94613839893606,215.20401499483705,148.257876595901,66.77515516250303,85.21739130434784,92.44445386372392
1502323200,3342.8,3448,3317,3444.98,9341,11650.15,9341,11650.15,68.91920564286343,1184913,1469150.69965036,1469150.69965036,1184913,25.240440316607387,85.71428571428571,21.428571428571427,64.66727769518297,229.0919737148797,164.42469601969674,68.91920564286343,95.54903943377148,91.54553216132528
1502409600,3444.98,3725,3416.86,3656.15,15316,11804.95,15316,11804.95,72.8225098278394,1200229,1477622.3652569025,1477622.3652569025,1200229,26.84689796853762,100,14.285714285714286,71.82631390122279,254.20758839622522,182.38127449500243,72.8225098278394,94.3795918367347,91.71534085828472
1502496000,3656.14,3974,3622.87,3874,18978,12245.15,18978,12245.15,76.15014736711043,1219207,1485790.693625313,1485790.693625313,1219207,28.87998912218766,100,7.142857142857143,84.78814783615809,288.36645929020005,203.57831145404197,76.15014736711043,93.2157394843962,94.38145691830084
1502582400,3874,4200,3850,4060.47,23518,13015.85,23518,13015.85,78.5689788988852,1242725,1490557.4562538844,1490557.4562538844,1242725,31.16413206334015,100,0,98.51173458501131,326.7179796853061,228.20624510029478,78.5689788988852,90.99806451612902,92.86446527908669
1502668800,4060.47,4328,3985.01,4320.6,20073,13059.35,20073,13059.35,81.40258034870621,1262798,1509764.3073865704,1509764.3073865704,1262798,33.48191792013459,100,14.285714285714286,116.46964109231197,373.79329646568476,257.3236553733728,81.40258034870621,99.5589988081049,94.59093426954342
1502755200,4320.53,4434.42,3807.14,4159.93,32002,14008.95,32002,14008.95,74.82213850972738,1230796,1513758.9455067082,1513758.9455067082,1230796,34.5204322811619,100,7.142857142857143,109.02022325274731,393.59893443930696,284.57871118655964,74.82213850972738,84.61741069927484,91.72482467450298
1502841600,4159.93,4385.5,3928.82,4370.01,17970,14405.95,17970,14405.95,77.3952105623091,1248766,1530509.90679251,1530509.90679251,1248766,35.484767044972976,92.85714285714286,0,109.44841724604714,421.38923274411854,311.9408154980714,77.3952105623091,96.28660213429575,93.4876705472252
1502928000,4370.01,4469,4180,4280.01,19980,14546.05,19980,14546.05,73.91038490421566,1228786,1524358.2791108491,1524358.2791108491,1228786,36.56335437198691,100,0,95.39183944435143,431.1806148035107,335.7887753591593,73.91038490421566,88.94148624926859,89.94849969427979
1503014400,4280.01,4350,3960.47,4101.72,20805,15092.85,20805,15092.85,67.43287882369444,1207981,1518641.7511155729,1518641.7511155729,1207981,36.246822292845806,92.85714285714286,0,67.14147749763231,419.71562223119963,352.5741447335673,67.43287882369444,77.21107429606742,87.47972089321064
1503100800,4101.72,4186.1,4000,4157.41,10517,15197,10517,15197,68.36548536477689,1218498,1525916.0565427626,1525916.0565427626,1218498,35.95289964792906,85.71428571428571,0,46.25468525437856,410.3925013015405,364.13781604716195,68.36548536477689,76.37680060652008,80.8431203839521
1503187200,4157.41,4190.21,4044.52,4050.99,8338,15041.7,8338,15041.7,64.56080030957267,1210160,1518318.6270692227,1518318.6270692227,1210160,35.69283583811966,78.57142857142857,0,20.627250742847764,389.92187947572165,369.2946287328739,64.56080030957267,67.31743549648161,73.63510346635643
1503273600,4050.99,4089.99,3950.88,4002,12390,15172.5,12390,15172.5,62.82739651558263,1197770,1515034.7560319141,1515034.7560319141,1197770,34.873609706123595,71.42857142857143,0,-3.010059280372843,365.53205463240784,368.5421139127807,62.82739651558263,62.228441094161994,68.64089239905462
1503360000,4002,4145,3583.46,4092,21935,15848.4,21935,15848.4,64.70237412741511,1219705,1532829.1605266964,1532829.1605266964,1219705,32.47389443736999,64.28571428571429,7.142857142857143,-15.284013351229078,349.43709722374433,364.7211105749734,64.70237412741511,69.5077565149873,66.35121103521037
1503446400,4092,4247.88,4058.26,4143.49,11763,16065.55,11763,16065.55,65.76625401060284,1231468,1531640.5776767859,1531640.5776767859,1231468,30.484780702228097,57.142857142857146,0,-22.214997977342136,336.95236310329574,359.1673610806379,65.76625401060284,71.74392361111109,67.82670707342018
1503532800,4142.5,4349.99,4112.76,4312.03,10232,16191.4,10232,16191.4,69.05412418696679,1241700,1538598.0616374991,1538598.0616374991,1241700,29.037320676215785,50,0,-17.913289175119644,336.7757496117383,354.68903878685796,69.05412418696679,85.08088277225461,75.44418763278439
1503619200,4312.03,4453.9,4284.01,4360,10908,15655.95,10908,15655.95,69.93906481921023,1252608,1537448.1276802327,1537448.1276802327,1252608,28.080566169066216,42.857142857142854,0,-14.450316146078706,336.6261436042596,351.0764597503383,69.93906481921023,87.6911263184046,81.50531090059015
1503705600,4360,4374.39,4260.01,4344.32,6139,15530.2,6139,15530.2,69.24204954445176,1246469,1540359.2953668912,1540359.2953668912,1246469,27.069895849040147,35.714285714285715,71.42857142857143,-15.723640327629482,331.42190934080145,347.14554966843093,69.24204954445176,85.92045531540074,86.23082146868671
1503792000,4344.32,4392,4309.87,4340.11,7031,15316.1,7031,15316.1,69.0430906224046,1239438,1538505.8782233382,1538505.8782233382,1239438,26.202485003588183,28.571428571428573,64.28571428571429,-19.131008124927916,323.231789512271,342.3627976371989,69.0430906224046,85.44503918512994,86.35220693964516
1503878400,4343.5,4396,4200,4384.99,10427,15037.8,10427,15037.8,70.03166985999462,1249865,1547761.4366927259,1547761.4366927259,1249865,24.805375911882795,21.428571428571427,57.142857142857146,-20.520920712808504,316.7116467461883,337.2325674589968,70.03166985999462,90.51313322944189,87.29287590999093
1503964800,4384.99,4656.83,4350,4599,14482,15107.25,14482,15107.25,74.25381097780453,1264347,1556784.4264264547,1556784.4264264547,1264347,24.54561747755989,100,50,-9.733217134708525,325.0660460406111,334.79926317531965,74.25381097780453,94.61229585324726,90.19015608927309
1504051200,4599.01,4635.21,4500.55,4581.98,10394,15159.9,10394,15159.9,73.36851175651223,1253953,1558961.0995290834,1558961.0995290834,1253953,24.30441321711719,92.85714285714286,42.857142857142854,-6.599939811917352,326.54933841042293,333.1492782223403,73.36851175651223,93.02663573604626,92.71735493957853
1504137600,4581.98,4769.03,4580.84,4743.94,13628,15075.5,13628,15075.5,76.26810243480622,1267581,1568955.2558604504,1568955.2558604504,1267581,24.55757383204152,100,35.714285714285715,3.008567918116455,336.9099881199859,333.9014202018694,76.26810243480622,97.88371838018843,95.17421665649404
1504224000,4743.94,4948,4706,4947.99,16761,14964.65,16761,14964.65,79.32266690883132,1284342,1585714.8706538389,1585714.8706538389,1284342,25.35321178306934,100,28.571428571428573,18.851159104065573,357.4653690819514,338.6142099778858,79.32266690883132,99.99926715230039,96.96987375617842
1504310400,4948,4980,4500,4649.99,19572,14767.35,19572,14767.35,65.96847471477255,1264770,1578374.5551538388,1578374.5551538388,1264770,24.940453391073408,100,21.428571428571427,5.688034492853717,345.72425309395294,340.0362186010992,65.96847471477255,76.36945594111158,91.4174804912002
1504396800,4642.39,4749.99,4524,4626.05,11569,14342.15,11569,14342.15,65.02143233771703,1253201,1577253.9506580648,1577253.9506580648,1253201,24.5571777413629,92.85714285714286,14.285714285714286,-7.4883733380821695,330.67575192849654,338.1641252665787,65.02143233771703,74.65521932776721,83.67464747372645
1504483200,4626.05,4628.05,4234.16,4498.25,20525,13768.3,20525,13768.3,60.064191732344504,1232676,1584251.5953050475,1584251.5953050475,1232676,22.814323404437623,85.71428571428571,7.142857142857143,-26.593412808847006,304.92235925551995,331.51577206436696,60.064191732344504,65.50403139186848,72.17623555358249
1504569600,4498.46,4514.95,4242.38,4432.51,17329,13736.25,17329,13736.25,57.63021062813329,1215347,1591098.1301768236,1591098.1301768236,1215347,21.19595866300701,78.57142857142857,0,-44.391750012525506,276.02608454871006,320.41783456123557,57.63021062813329,40.602556035324504,60.2539355849868
1504656000,4432.51,4692,4431,4616.18,16150,13544.75,16150,13544.75,62.2347589574785,1231497,1597865.0420542182,1597865.0420542182,1231497,20.428984684639566,71.42857142857143,0,-44.42011199308047,264.89269456988495,309.3128065629654,62.2347589574785,58.04852174715191,54.71836972478169
1504742400,4616.18,4665.44,4475.01,4624.18,8463,12927.65,8463,12927.65,62.426295301202046,1239960,1602660.727240376,1602660.727240376,1239960,19.7167945618698,64.28571428571429,0,-44.418717565875795,253.78940960562068,298.20812717149647,62.426295301202046,54.38205128205132,51.011043021509295
1504828800,4624.18,4679.99,4140,4350,22096,13506.6,22096,13506.6,52.583109846666744,1217864,1597750.8232791915,1597750.8232791915,1217864,19.018003167074866,57.142857142857146,100,-62.30557463069454,220.3261588831283,282.63173351382284,52.583109846666744,25,45.81019100973447
1504915200,4350,4449.95,4180,4334.36,10064,13592.9,10064,13592.9,52.07866509383486,1207800,1599196.2067946573,1599196.2067946573,1207800,18.369125443336713,50,92.85714285714286,-73.82535676260233,190.35003756056994,264.17539432317227,52.07866509383486,23.1380952380952,34.17338217338223
1505001600,4334.36,4349.99,4139,4251.36,10067,13476.75,10067,13476.75,49.37176621374921,1197733,1599851.3085056387,1599851.3085056387,1197733,17.930866183923357,42.857142857142854,100,-84.88098857577046,158.07415860345918,242.95514717922964,49.37176621374921,13.360285374554064,20.499460204216476
1505088000,4251.36,4365,4111.14,4210.72,9065,12833.25,9065,12833.25,48.05469781485466,1188668,1597898.0448957752,1597898.0448957752,1188668,17.638902923211226,35.714285714285715,100,-92.16936829108778,127.74343681536993,219.9128051064577,48.05469781485466,11.460994866837002,15.986458493162145
1505174400,4210.72,4375.37,4080,4164.52,12277,12858.95,12277,12858.95,46.53491492867989,1176391,1592647.1615630062,1592647.1615630062,1176391,17.500736765831366,28.571428571428573,100,-96.85919204366405,98.83881505187765,195.6980070955417,46.53491492867989,9.39111111111116,11.404130450834133
1505260800,4164.52,4174.53,3726,3855.32,22772,13485.95,22772,13485.95,37.896614467960795,1153619,1583006.3904217225,1583006.3904217225,1153619,18.63177387997153,21.428571428571427,100,-116.2377268432918,50.40084854142697,166.63857538471876,37.896614467960795,10.312599681020746,10.38823521965636
1505347200,3855.61,3923,3230.05,3250.4,36344,14757.75,36344,14757.75,27.242109833343008,1117275,1548797.033325251,1548797.033325251,1117275,20.824220403590544,14.285714285714286,100,-162.4142365960905,-36.379220360394356,126.03501623569613,27.242109833343008,1.162890368296232,6.95553372014277
1505433600,3249.99,3894.48,2975.01,3740.02,54482,17174.9,54482,17174.9,41.56291092933809,1171757,1584974.380166366,1584974.380166366,1171757,23.284503946651864,7.142857142857143,100,-152.74538828897374,-64.89671912552103,87.8486691634527,41.56291092933809,38.15530252021206,16.543597523176402
1505520000,3740.02,4042.98,3600,3726.51,19030,17774.85,19030,17774.85,41.321230577019634,1152727,1576813.8790150725,1576813.8790150725,1152727,24.809421451581535,0,92.85714285714286,-140.34105201900252,-87.57764586030044,52.76340615870207,41.321230577019634,42.338505222594065,27.218899370367506
1505606400,3726.51,3841,3475.64,3719.97,11712,17839.1,11712,17839.1,41.19634818989307,1141015,1580766.3905105838,1580766.3905105838,1141015,26.45549510169511,0,85.71428571428571,-126.10774593115255,-104.87127625523863,21.236469675913924,41.19634818989307,43.38755613020458,41.29378795767029
1505692800,3719.98,4130,3717.56,4100,16878,17958.9,16878,17958.9,50.54887456604818,1157893,1595189.0515521897,1595189.0515521897,1157893,26.64174640419944,14.285714285714286,78.57142857142857,-86.51679105509194,-86.90951914295101,-0.39272808785906577,50.54887456604818,65.52105719893534,50.41570618391139
1505779200,4100,4125.22,3850.44,3910.11,13759,18127.15,13759,18127.15,46.563753479615706,1144134,1587405.7377738943,1587405.7377738943,1144134,26.81469404223918,7.142857142857143,71.42857142857143,-69.28135014902853,-86.99441577414473,-17.713065625116197,46.563753479615706,54.46158684674925,54.456733391963105
1505865600,3910.11,4044,3850.01,3872.06,9883,17939.9,9883,17939.9,45.784840419383926,1134251,1579769.4530684971,1579769.4530684971,1134251,26.97639928017301,0,64.28571428571429,-57.11344230835521,-89.10486851056021,-31.991426202204998,45.784840419383926,52.61352039320109,57.53205481296195
1505952000,3872.07,3903.57,3571,3617.47,14950,17849.35,14950,17849.35,40.85981209074789,1119301,1568997.3795200712,1568997.3795200712,1119301,27.799600351292565,7.142857142857143,57.142857142857146,-62.44853168935537,-110.05209081389921,-47.60355912454384,40.85981209074789,37.68138042674986,48.25216255556679
1506038400,3617.47,3767.77,3509.79,3619.01,12640,17502.75,12640,17502.75,40.90122441200958,1131941,1567060.0758531203,1567060.0758531203,1131941,28.697691234570843,0,50,-61.98653536894871,-125.08672833572973,-63.10019296678102,40.90122441200958,43.662793062768664,44.65256462757326
1506124800,3619.01,3818.89,3580,3787.33,6584,17253.5,6584,17253.5,45.401386662377206,1138525,1571904.43802818,1571904.43802818,1138525,29.26449182616091,0,42.857142857142854,-47.130466825439285,-122.01327649858013,-74.88280967314084,45.401386662377206,58.00794081521894,46.450704768245885
1506211200,3787.33,3789.36,3630.01,3669.01,4697,16462.1,4697,16462.1,42.92689342591332,1133828,1569506.565734487,1569506.565734487,1133828,29.790806661208823,14.285714285714286,35.714285714285715,-42.216527622834846,-127.6534692016844,-85.43694157884956,42.92689342591332,49.55868490959469,50.40980626252749
1506297600,3669.01,3969.37,3669.01,3919.78,9574,16074.35,9574,16074.35,49.24126385513115,1143402,1575919.1949793932,1575919.1949793932,1143402,29.321823382436047,7.142857142857143,28.571428571428573,-20.141037748517277,-110.61323876449615,-90.47220101597887,49.24126385513115,67.46622297123598,58.344282898683254
1506384000,3919.98,3960,3854.29,3885.09,5893,15561.5,5893,15561.5,48.4428254610473,1137509,1573460.2012228896,1573460.2012228896,1137509,28.886338909289893,0,21.428571428571427,-6.637738859133307,-98.7693745898955,-92.1316357307622,48.4428254610473,75.87034813925574,64.2984186733622
1506470400,3885.09,4228.39,3880.36,4200,12041,15740.4,12041,15740.4,55.497310472948826,1149550,1583536.7499399541,1583536.7499399541,1149550,27.205094664348834,100,14.285714285714286,23.110595571097164,-63.24339126689074,-86.3539868379879,55.497310472948826,97.73492476343962,80.35716529131051
1506556800,4200,4269.95,4122,4189.42,7883,15029.75,7883,15029.75,55.22391751926323,1141667,1582838.2292910863,1582838.2292910863,1141667,25.466197741787855,100,7.142857142857143,40.656861593957984,-35.532909845540416,-76.1897714394984,55.22391751926323,93.78117905076685,89.12881731782079
1506643200,4189.42,4212.99,4015.17,4156.99,10344,15043.75,10344,15043.75,54.340261843193744,1131323,1587325.7537072222,1587325.7537072222,1131323,24.277350914019348,92.85714285714286,0,48.1482221076529,-16.00449380493228,-64.15271591258518,54.340261843193744,85.7788520854578,92.43165196655481
1506729600,4156.99,4356.28,4143.52,4339,6217,14851.25,6217,14851.25,58.36677309918575,1137540,1592532.8856869177,1592532.8856869177,1137540,22.54606751586374,100,7.142857142857143,62.51997343857098,13.997250885628546,-48.52272255294243,58.36677309918575,98.03779069767445,92.53260727796642
1506816000,4339.01,4396.99,4256.92,4394.81,5366,14666.3,5366,14666.3,59.54484244101516,1142906,1597731.8566300175,1597731.8566300175,1142906,21.112020527126145,100,0,72.25454464569845,41.79545825418063,-30.45908639151782,59.54484244101516,99.7542831379622,94.5236419736982
1506902400,4394.81,4470,4354.23,4392.71,8644,14484.65,8644,14484.65,59.47664482434234,1134262,1594834.0969340687,1594834.0969340687,1134262,20.09282221117574,100,28.571428571428573,74.71195524552718,62.93085766539116,-11.781097580136024,59.47664482434234,91.95071911352724,96.5809309830547
1506988800,4392.71,4419.95,4240,4307.99,10606,13876.35,10606,13876.35,56.65739856599811,1123656,1592242.5669535187,1592242.5669535187,1123656,18.70496899164722,92.85714285714286,21.428571428571427,67.0364619911148,72.0144799087575,4.978017917642681,56.65739856599811,83.12764916007954,91.61088380385638
1507075200,4307.99,4344,4175.3,4214.84,6531,12385.7,6531,12385.7,53.646411936130974,1117125,1588773.045791693,1588773.045791693,1117125,17.707814833579697,85.71428571428571,14.285714285714286,52.72145038443749,70.87983089818954,18.15838051375205,53.646411936130974,73.42664625446518,82.83500484269071
1507161600,4214.84,4365.21,4150.01,4320.04,6454,9984.3,6454,9984.3,56.46059442651434,1123579,1592517.685382771,1592517.685382771,1123579,16.89757607928322,78.57142857142857,7.142857142857143,47.533404634618265,77.57513630702488,30.041731672406616,56.46059442651434,84.38258297664052,80.3122927970618
1507248000,4320.02,4407,4299.99,4362.99,6419,9353.75,6419,9353.75,57.59258500324363,1129998,1593656.8014466902,1593656.8014466902,1129998,15.922077244307362,71.42857142857143,0,44.25694237937888,85.36290964663021,41.10596726725134,57.59258500324363,87.976404494382,81.92854457516263
1507334400,4363,4449.42,4320,4425,4141,8975.2,4141,8975.2,59.240272457561645,1134139,1596235.0874921237,1596235.0874921237,1134139,14.786864493250091,64.28571428571429,0,43.46587533895618,95.43831144094656,51.97243610199038,59.240272457561645,94.64279336658768,89.0005936125368
1507420800,4425,4612,4420.01,4603.49,7123,8487.45,7123,8487.45,63.62166976796966,1141262,1602726.6303328967,1602726.6303328967,1141262,14.541554306226262,100,0,51.60848886984998,116.48304718930285,64.87455831945287,63.62166976796966,99.09755140563524,93.90558308886837
1507507200,4603.5,4875.39,4561,4769.55,14270,8513,14270,8513,67.15869088721124,1155532,1607388.5842754522,1607388.5842754522,1155532,15.362558022212298,100,0,64.01283130565959,144.89059745152736,80.87776614586777,67.15869088721124,89.63470766820096,94.45835081347468
1507593600,4769.55,4925.65,4701.53,4750,13713,8704.5,13713,8704.5,66.34089926414322,1141819,1599606.952381824,1599606.952381824,1141819,16.298825644786525,100,0,66.4469919557656,163.93650609057477,97.48951413480917,66.34089926414322,83.19605085670008,90.6427699768455
1507680000,4750,4869.97,4720.21,4814.99,7151,8314.55,7151,8314.55,67.74693353337804,1148970,1601507.391751482,1601507.391751482,1148970,17.168217008605456,92.85714285714286,0,67.74813225720689,182.1746794563178,114.4265471991109,67.74693353337804,87.8459713557684,86.89224329355655
1507766400,4814.99,5440.92,4809.59,5440,20108,8687.95,20108,8687.95,77.4868428332607,1169078,1621556.7873449116,1621556.7873449116,1169078,19.521027235318826,100,7.142857142857143,103.8556658234391,244.24612947840978,140.3904636549707,77.4868428332607,99.93547255830265,90.32583159025711
1507852800,5440,5867,5390,5624.8,26606,9689.05,26606,9689.05,79.46175139173793,1195684,1621144.0317893561,1621144.0317893561,1195684,22.4027149685969,100,0,131.55647394231042,304.8360560828587,173.27958214054829,79.46175139173793,85.94703738946782,91.24282710117969
1507939200,5624.87,5839.8,5567.86,5819.13,8989,9903.65,8989,9903.65,81.3176904807783,1204673,1628766.5345473175,1628766.5345473175,1204673,25.07856786378368,92.85714285714286,0,152.84432580203477,364.33498939309175,211.49066359105697,81.3176904807783,97.21198143262339,94.36483046013136
1508025600,5819.13,5849.83,5455.5,5693.7,11822,10016.05,11822,10016.05,76.51178837199504,1192851,1631226.9903584402,1631226.9903584402,1192851,26.91886389776895,85.71428571428571,28.571428571428573,148.2420172290735,396.79318512739883,248.55116789832533,76.51178837199504,89.90675542664779,91.02192474957974
1508112000,5693.7,5785.3,5575.55,5754.9,8798,10161.3,8798,10161.3,77.21923372208828,1201649,1637474.7238506929,1637474.7238506929,1201649,28.62771021504099,78.57142857142857,21.428571428571427,139.22593534775984,422.5835870830251,283.3576517352653,77.21923372208828,93.4711326216227,93.52995649363136
1508198400,5754.9,5769.99,5525,5594,9119,10015.2,9119,10015.2,71.1516313501317,1192530,1633492.349835427,1633492.349835427,1192530,29.906305650118636,71.42857142857143,14.285714285714286,113.42479657328482,425.1386474518713,311.71385087858647,71.1516313501317,84.10008212045497,89.15932338957522
1508284800,5593.97,5600,5102,5574.44,17621,10502.1,17621,10502.1,70.42714666729866,1174909,1649304.5435703667,1649304.5435703667,1174909,28.94861189689789,64.28571428571429,7.142857142857143,87.21711819680502,420.7352486245927,333.5181304277877,70.42714666729866,82.96087921304141,86.8440313183731
1508371200,5574.02,5750,5529.44,5704.01,8881,10428.95,8881,10428.95,72.429794740653,1183790,1654481.9056487128,1654481.9056487128,1183790,28.492240082988214,57.142857142857146,0,71.44682123094816,422.8266569664729,351.37983573552475,72.429794740653,89.59866242078866,85.55320791809508
1508457600,5704,6063.99,5630,5989.1,16688,10952.5,16688,10952.5,76.24205459983416,1200478,1665410.4903626463,1665410.4903626463,1200478,28.846277861133412,100,0,72.80725907285284,442.3889095765908,369.58165050373793,76.24205459983416,95.70582400128444,89.42178854503824
1508544000,5989.1,6189.1,5868.26,6024.86,14630,11415.7,14630,11415.7,76.67768124252412,1215108,1665062.1136016438,1665062.1136016438,1215108,29.445534028536137,100,0,68.75599262460918,455.5266412844994,386.77064865989024,76.67768124252412,90.71613089215356,92.00687243807562
1508630400,6024.85,6082.3,5755.95,6005.05,10753,11521.15,10753,11521.15,75.84798098162405,1204355,1670724.4486713542,1670724.4486713542,1204355,29.490842253598743,92.85714285714286,0,57.82209245760657,459.04826423189843,401.22617177429186,75.84798098162405,88.69541182974018,91.70578890772613
1508716800,6000.01,6057.02,5650.98,5905.99,16422,11811.95,16422,11811.95,71.67162019743064,1187933,1674929.8460706251,1674929.8460706251,1187933,29.069572724222027,85.71428571428571,0,37.958125826157925,448.67382905698923,410.7157032308313,71.67162019743064,80.96829056783879,86.79327776324426
1508803200,5906,5906,5462.19,5525.43,18263,12398.55,18263,12398.55,58.373775263580804,1169670,1661871.560340245,1661871.560340245,1169670,27.900821688002686,78.57142857142857,0,-4.512918118168386,405.07455558312085,409.58747370128924,58.373775263580804,54.81826413141897,74.82732217633271
1508889600,5525.43,5765,5376.71,5739.97,14144,12783.05,14144,12783.05,62.58797468334509,1183814,1674192.0556401499,1674192.0556401499,1183814,26.484036334877537,71.42857142857143,0,-20.939060255551965,383.41364838184927,404.35270863740124,62.58797468334509,67.44278765648673,67.74311411858157
1508976000,5739.97,6000,5701,5891.61,11824,13053.3,11824,13053.3,65.26473140924774,1195638,1677443.4579143974,1677443.4579143974,1195638,25.882054662221833,64.28571428571429,0,-24.146083700457325,374.1701040118296,398.31618771228693,65.26473140924774,72.63453224174404,64.96519467654998
1509062400,5891.61,5998,5708.8,5780,9333,13312.9,9333,13312.9,61.762105226634496,1186305,1672705.959989086,1672705.959989086,1186305,25.323071680470104,57.142857142857146,35.714285714285715,-35.64446836846355,353.7606022517075,389.40507062017105,61.762105226634496,62.36776745469596,67.48169578430897
1509148800,5780,5894,5715,5752.01,5421,13227.8,5421,13227.8,60.87969170794751,1180884,1669526.6494862929,1669526.6494862929,1180884,24.804016054557785,50,28.571428571428573,-46.319279294293324,331.5059715023044,377.82525079659774,60.87969170794751,59.793027320393705,64.93177567227796
1509235200,5752.01,6298.99,5728,6140.01,12444,13136.5,12444,13136.5,67.75674579100072,1193328,1675041.116149457,1675041.116149457,1193328,25.431581439931435,100,21.428571428571427,-29.265217947332417,341.2437283624322,370.5089463097646,67.75674579100072,86.71835186593042,69.62638221367342
1509321600,6140.01,6200,6028,6124.16,8336,12867.65,8336,12867.65,67.2367627367073,1184992,1676025.9273122477,1676025.9273122477,1184992,26.014320726349823,92.85714285714286,14.285714285714286,-21.431300914935775,343.7198201660949,365.1511210810307,67.2367627367073,85.39419711108698,77.30185876580377
1509408000,6124.16,6472.13,6095.96,6445.01,15015,13260.85,15015,13260.85,71.9324449208764,1200007,1688875.9125582802,1688875.9125582802,1200007,27.165993142369455,100,7.142857142857143,1.7491950864966839,367.33761493915154,365.58841985265485,71.9324449208764,98.02062578003549,90.04439158568437
1509494400,6445.01,6784,6363.59,6783.69,20579,13284.4,20579,13284.4,75.86466183703429,1220586,1709424.5636607753,1709424.5636607753,1220586,28.801956223659026,100,0,34.46735174517215,408.67260953412006,374.2052577889479,75.86466183703429,99.97797184659875,94.46426491257381
1509580800,6783.69,7445,6759,7039.98,35896,13748.9,35896,13748.9,78.33787083584247,1256482,1702933.9808036324,1702933.9808036324,1256482,31.171021596019582,100,42.857142857142854,66.1118941037837,456.8451254186775,390.7332313148938,78.33787083584247,80.41763969269297,92.80541243977581
1509667200,7039.99,7449.99,6955.89,7170.01,24735,14536.2,24735,14536.2,79.4864096919647,1281217,1699636.9820179616,1699636.9820179616,1281217,33.376121081897686,100,35.714285714285715,87.21635600457432,499.7536763206117,412.5373203160374,79.4864096919647,86.49579410402842,88.96380188110679
1509753600,7170.01,7498,7011.1,7412.55,13655,14627.85,13655,14627.85,81.46091103671193,1294872,1708499.1303030304,1708499.1303030304,1294872,35.47696996619897,100,28.571428571428573,107.58951054211985,547.0242084936872,439.43469795156733,81.46091103671193,95.97179074996818,87.62840818222992
1509840000,7412.35,7630,7310,7392,16518,15013.85,16518,15013.85,80.75169177475267,1278354,1700446.6053030305,1700446.6053030305,1278354,37.573852202699406,100,21.428571428571427,109.4012939348259,576.1863153700997,466.7850214352738,80.75169177475267,89.437666700691,90.63508385156258
1509926400,7391.95,7432.49,6900.73,6969.76,23885,15752.15,23885,15752.15,67.70792578006106,1254469,1682762.8297275829,1682762.8297275829,1254469,37.69522447094178,92.85714285714286,14.285714285714286,73.59992775078501,558.7849311237551,485.1850033729701,67.70792578006106,70.69884480026984,85.36943408364306
1510012800,6969.76,7232.84,6968.49,7126.63,14508,15596.5,14508,15596.5,69.66819123042521,1268977,1685612.840849202,1685612.840849202,1268977,37.80792729145256,85.71428571428571,7.142857142857143,52.88983304452603,551.2972946786276,498.4074616341016,69.66819123042521,77.66066507196145,79.26572552430748
1510099200,7128.99,7898,7031.66,7467.96,38150,17059.95,38150,17059.95,73.4454530390075,1307127,1685888.5051380491,1685888.5051380491,1307127,38.893652154360886,100,0,54.37557196012324,566.3769265842557,512.0013546241324,73.4454530390075,80.42603550295858,76.26184845839667
1510185600,7467.97,7470.01,7079,7156,18037,17127.4,18037,17127.4,65.42610637053696,1289090,1674955.410409014,1674955.410409014,1289090,39.9018252413472,92.85714285714286,0,27.879969973137577,546.8513170905544,518.9713471174168,65.42610637053696,66.10634021560386,74.73101359684135
1510272000,7156,7350,6426,6577.62,33906,18091.2,33906,18091.2,53.715647175563795,1255184,1652176.7431362867,1652176.7431362867,1255184,38.599899276079064,85.71428571428571,0,-31.83069725027707,479.1829755545705,511.01367280484754,53.715647175563795,39.5153458543289,62.01590719096382
1510358400,6577.63,6894.99,6201.01,6346.7,25661,18836.6,25661,18836.6,49.877181026965715,1229523,1637289.9760824812,1637289.9760824812,1229523,36.777217188961984,78.57142857142857,0,-86.98315797028204,402.284725341995,489.26788331227704,49.877181026965715,28.51152073732718,44.71106893575336
1510444800,6346.64,6486,5511.11,5886.35,52451,20638.05,52451,20638.05,43.24304394152461,1177072,1625216.2765779218,1625216.2765779218,1177072,34.74324655310677,71.42857142857143,100,-150.83087443280874,300.7292902712661,451.56016470407485,43.24304394152461,15.720875281223712,27.915913957626643
1510531200,5886.35,6841.45,5850,6535.87,36416,21545.7,36416,21545.7,52.78525931323654,1213488,1639184.344196057,1639184.344196057,1213488,32.40320374990087,64.28571428571429,92.85714285714286,-145.608521325246,269.5495130475174,415.1580343727634,52.78525931323654,42.932854048573674,29.055083355708234
1510617600,6535.87,6748,6450,6605,20266,21851.8,20266,21851.8,53.677900791074215,1233754,1640000.4247329696,1640000.4247329696,1233754,30.230306861209673,57.142857142857146,85.71428571428571,-134.07541372964596,247.56376721070592,381.6391809403519,53.677900791074215,45.82909141183717,34.827606913878235
1510704000,6605,7349,6605,7294,27864,22653.8,27864,22653.8,61.492132299973775,1261618,1663744.7473136147,1663744.7473136147,1261618,29.311666332444492,50,78.57142857142857,-79.32719177908126,282.4801912165003,361.8073829955816,61.492132299973775,74.69510534628743,54.485683602232804
1510790400,7294,7985.37,7130,7838.53,29331,23653.7,29331,23653.7,66.32682993345179,1290949,1683005.3355853567,1683005.3355853567,1290949,29.35475065731025,100,71.42857142857143,-9.401500803942724,350.05550699065316,359.4570077945959,66.32682993345179,94.06529629060809,71.52983101624427
1510876800,7838.54,7988.5,7536,7714.71,24793,24622.3,24793,24622.3,64.34844155666855,1266156,1677795.7920715446,1677795.7920715446,1266156,29.39878020774937,100,64.28571428571429,23.74040576124355,389.13251499615035,365.3921092349068,64.34844155666855,88.94844977980858,85.90295047223475
1510963200,7714.7,7847.98,7502,7777.01,14697,24734.95,14697,24734.95,64.91548935012665,1280853,1686463.27539428,1686463.27539428,1280853,29.353209402047742,92.85714285714286,57.142857142857146,43.91322977486823,420.2836464534921,376.3704166786239,64.91548935012665,91.4631931185643,91.49231306299369
1511049600,7777.01,8098.62,7700,8031.82,14760,25056.15,14760,25056.15,67.2124977521143,1295613,1696276.3685657214,1696276.3685657214,1295613,29.661196562544994,100,50,67.08524265739896,460.2269700003726,393.14172734297364,67.2124977521143,97.4183674652465,92.61000345453984
1511136000,8031.83,8293.25,7969,8256.01,15691,25089.95,15691,25089.95,69.12764168479475,1311304,1708363.1567538478,1708363.1567538478,1311304,30.205114792043968,100,42.857142857142854,88.81537610971549,504.160947480118,415.3455713704025,69.12764168479475,98.66146204001237,95.8476742079411
1511222400,8256.01,8375,7802.99,8109,31270,25624.5,31270,25624.5,66.38918578198067,1280034,1710550.3784807408,1710550.3784807408,1280034,30.243228975826376,100,35.714285714285715,84.61109294933192,521.1094375570674,436.4983446077355,66.38918578198067,90.71193376840591,95.59725442455498
1511308800,8109,8298.98,8103.13,8250,13682,24513.8,13682,24513.8,67.7104010397413,1293716,1717388.9333952162,1717388.9333952162,1293716,30.278620717910037,92.85714285714286,28.571428571428573,82.55929491999734,539.6974632577321,457.1381683377348,67.7104010397413,95.63530722199526,95.0029010101379
1511395200,8250,8274.98,8031.16,8031.16,11909,23872.5,11909,23872.5,63.535887043308136,1281807,1705479.9333952162,1705479.9333952162,1281807,30.093114533912914,85.71428571428571,21.428571428571427,58.811874032070136,530.6530108778225,471.8411368457523,63.535887043308136,87.9939522816868,91.44706442402936
1511481600,8031.16,8324,7900,8215.01,14600,23919.75,14600,23919.75,65.4623679340815,1296407,1712574.0183008767,1712574.0183008767,1296407,29.520670968721767,78.57142857142857,14.285714285714286,48.27562697953289,532.1856705701684,483.91004359063555,65.4623679340815,94.41354241957617,92.68093397441946
1511568000,8215.01,8795.5,8203.98,8795.5,16476,23917.65,16476,23917.65,70.72200909742585,1312883,1729050.0183008767,1729050.0183008767,1312883,29.7973117480688,100,7.142857142857143,71.7748234824628,573.6285729437141,501.85374946125125,70.72200909742585,100.00000000000001,94.13583156708772
1511654400,8795.5,9596,8795.5,9401.11,28643,24155.55,28643,24155.55,74.99955160121478,1341526,1743746.149418928,1743746.149418928,1341526,31.052309606648947,100,0,116.81442029240918,647.8717748267627,531.0573545343535,74.99955160121478,94.79738387613456,96.40364209857029
1511740800,9401.11,9795,9401,9768.71,25662,24713.25,25662,24713.25,77.17903797771527,1367188,1765983.5099265422,1765983.5099265422,1367188,32.41758926854396,100,0,157.53858676049538,727.9805879849728,570.4420012244774,77.17903797771527,99.21405082212253,98.00381156608574
1511827200,9768.71,9989.95,9705.99,9949,18972,23754.35,18972,23754.35,78.18358565377952,1386160,1779483.588529162,1779483.588529162,1386160,33.87444490126508,100,0,181.11034807863678,796.8299363227734,615.7195882441366,78.18358565377952,98.79023323830482,97.600555978854
1511913600,9949,11485,8595.55,9935.98,69108,26307.9,69108,26307.9,77.91684329747072,1317052,1774494.6675511212,1774494.6675511212,1317052,36.25504627615984,100,0,179.94626375659277,840.6524179398775,660.7061541832848,77.91684329747072,64.4312284730195,87.47850417781565
1512000000,9920.81,10850,9135.6,9903,42440,26734.6,42440,26734.6,77.19837287140714,1274612,1770048.66661785,1770048.66661785,1274612,38.465604695704975,92.85714285714286,0,161.6553193196769,862.7753033328809,701.119984013204,77.19837287140714,60.28119507908612,74.50088559680351
1512086400,9903.01,10937,9517,10869.84,33257.43099,27114.421549500003,33257.43099,27114.421549500003,82.33959939569202,1307869.43099,1800160.2256849087,1800160.2256849087,1307869.43099,40.565506743512636,85.71428571428571,7.142857142857143,197.02616376285073,947.4026887167674,750.3765249539167,82.33959939569202,84.55536028119508,69.75592794443361
1512172800,10869.85,11100,10701,10930.24,20197.01811,25501.722455000003,20197.01811,25501.722455000003,82.60349366058954,1328066.4491,1803171.049336996,1803171.049336996,1328066.4491,42.60515895253557,78.57142857142857,0,205.8810340888033,1007.7278175649208,801.8467834761175,82.60349366058954,85.34319682959048,76.7265840632906
1512259200,10930.24,11891,10601,11290,31415.65085,25251.7049975,31415.65085,25251.7049975,84.12509587490662,1359482.0999500002,1805314.1324957556,1805314.1324957556,1359482.0999500002,44.873328901222095,100,0,216.28722992171402,1072.20582087826,855.918590956546,84.12509587490662,85.29847040491583,85.06567583856717
1512345600,11290,11650,10950,11643.98,20180.78654,25247.4443245,20180.78654,25247.4443245,85.47159922222032,1379662.8864900002,1825147.8095072675,1825147.8095072675,1379662.8864900002,46.97948671071673,92.85714285714286,7.142857142857143,226.25842810296876,1138.741626085257,912.4831979822882,85.47159922222032,93.95745118040317,88.1997061383032
1512432000,11643.99,11875,11532,11718.35,17711.46813,24739.817731,17711.46813,24739.817731,85.7451653049182,1397374.35462,1826681.426426979,1826681.426426979,1397374.35462,49.032276656606484,85.71428571428571,0,217.07452579310507,1183.8263552236695,966.7518294305644,85.7451653049182,95.67401653720873,91.64331270750927
1512518400,11718.34,14425,11717.5,14090,51353.20277,25840.9278695,51353.20277,25840.9278695,91.34322925915521,1448727.5573900002,1865326.7267571269,1865326.7267571269,1448727.5573900002,51.619705746142586,100,14.285714285714286,342.4782989072339,1394.8497030646067,1052.3714041573728,91.34322925915521,94.86590038314176,94.83245603358459
1512604800,14090,19697,13500,17390.01,84513.11187,28826.933463,84513.11187,28826.933463,94.55024917824412,1533240.66926,1886915.5514065456,1886915.5514065456,1533240.66926,54.51364443799945,100,7.142857142857143,604.130335636328,1807.5343237027828,1203.4039880664548,94.55024917824412,80.44426549122657,90.32806080385905
1512691200,17390.01,17777.69,13788.99,16367.03,68496.89161,31516.928043500004,68496.89161,31516.928043500004,84.14376022364253,1464743.77765,1906962.6598197334,1906962.6598197334,1464743.77765,57.200873223295126,92.85714285714286,0,660.2038545619102,2028.6588062688425,1368.4549517069322,84.14376022364253,71.02615326519923,82.11210637985589
1512777600,16367.03,16499,13550,15309.98,41168.59695,32837.35789100001,41168.59695,32837.35789100001,74.9625680675399,1423575.1807000001,1914933.369251599,1914933.369251599,1423575.1807000001,59.36759405910029,85.71428571428571,0,580.806268790476,2094.462787695027,1513.6565189045511,74.9625680675399,60.48245949853397,70.65095941831994
1512864000,15309.99,16300,13501,15290.01,52871.31426,34696.37360400001,52871.31426,34696.37360400001,74.7965230727648,1370703.8664400002,1929648.5572597538,1929648.5572597538,1370703.8664400002,61.30911126327475,78.57142857142857,21.428571428571427,485.52041957123083,2120.55704336859,1635.036623797359,74.7965230727648,60.302573087299415,63.93706195034423
1512950400,15290.01,17493,15200,16885.76,41163.65362,35191.056285000006,41163.65362,35191.056285000006,78.83151430821324,1411867.5200600002,1949010.0154814033,1949010.0154814033,1411867.5200600002,63.22836631836599,71.42857142857143,14.285714285714286,487.276032834774,2244.1316648408265,1756.8556320060525,78.83151430821324,74.67682149629101,65.15395136070815
1513036800,16885.76,18149.99,16375,17730.12,38218.84483,36417.8985265,38218.84483,36417.8985265,80.60123116388095,1450086.3648900003,1969147.6921033885,1969147.6921033885,1450086.3648900003,65.06714126062614,64.28571428571429,7.142857142857143,500.7007675681102,2382.7315914661904,1882.0308238980801,80.60123116388095,82.28267478572619,72.42068978977223
1513123200,17730.12,17900,15700,16689.61,31844.2044,37414.658746500005,31844.2044,37414.658746500005,72.55179520553517,1418242.1604900004,1965951.9814454648,1965951.9814454648,1418242.1604900004,65.8424540204634,57.142857142857146,0,399.306536461577,2381.1639944750514,1981.8574580134743,72.55179520553517,71.52470316435321,76.16139981545682
1513209600,16689.62,17199.6,16256,16749.78,16329.30351,37501.123922000006,16329.30351,37501.123922000006,72.72144897292921,1434571.4640000004,1966712.7234784232,1966712.7234784232,1434571.4640000004,66.56238729745515,50,0,300.5939809630763,2357.59993421732,2057.0059532542437,72.72144897292921,71.04891944990176,74.95209913332707
1513296000,16749.79,17899,16745,17738.67,28605.29934,38107.588889000006,28605.29934,38107.588889000006,75.41135337362545,1463176.7633400003,1987369.517370967,1987369.517370967,1463176.7633400003,67.36268445096424,42.857142857142854,0,267.3205493112123,2391.156639893259,2123.836090582047,75.41135337362545,78.47042656112575,73.68134972512694
1513382400,17738.68,19797,17630,19650.01,24840.11501,37917.444639500005,24840.11501,37917.444639500005,79.59877298690793,1488016.8783500004,2008839.7675860247,2008839.7675860247,1488016.8783500004,68.396385849255,100,7.142857142857143,335.066667372183,2542.6694247972755,2207.6027574250925,79.59877298690793,98.40158764680295,82.64031121927684
1513468800,19650.02,19891.99,19010,19378.99,21467.90059,37707.739669,21467.90059,37707.739669,77.58125808630535,1466548.9777600004,2005334.521082135,2005334.521082135,1466548.9777600004,69.3689219184968,100,0,322.54171714427684,2610.7799038554385,2288.2381867111617,77.58125808630535,94.2630219895124,90.37834539914705
1513555200,19378.99,19385,18200,19039.01,26383.85822,38078.33258,26383.85822,38078.33258,75.01274291133097,1440165.1195400003,2016311.5419932103,2016311.5419932103,1440165.1195400003,69.20209644382196,92.85714285714286,0,255.22499109564524,2607.2694255807182,2352.044434485073,75.01274291133097,89.7968777474614,94.15382912792559
1513641600,19039.01,19099,16800,17838.73,32145.81049,36230.2231045,32145.81049,36230.2231045,66.6261781826733,1408019.3090500003,2013213.8548005377,2013213.8548005377,1408019.3090500003,67.46238230556098,85.71428571428571,0,101.61064990701288,2479.057746868839,2377.447096961826,66.6261781826733,74.88210273668447,86.31400082455276
1513728000,17838.73,17890,14001,16496.89,47979.10302,36507.1782555,47979.10302,36507.1782555,58.72206381606763,1360040.2060300002,2026818.996283797,2026818.996283797,1360040.2060300002,63.546025576271006,78.57142857142857,0,-107.30626670286347,2243.3142635832464,2350.62053028611,58.72206381606763,46.88508586527824,70.52135544980807
1513814400,16496.9,17364.57,15151,15758.8,28737.59504,36281.186458000004,28737.59504,36281.186458000004,54.866326256806786,1331302.6109900002,2013862.885692278,2013862.885692278,1331302.6109900002,59.90940861335889,71.42857142857143,0,-301.15950899276413,1974.1711440451545,2275.3306530379186,54.866326256806786,35.32786000291033,52.36501620162437
1513900800,15758.8,15974.95,10400,14210.57,103036.53575,40423.16234000001,103036.53575,40423.16234000001,47.77940321379391,1228266.0752400002,2051680.6829974183,2051680.6829974183,1228266.0752400002,57.17748507697331,64.28571428571429,100,-526.4238634885851,1617.3008236771875,2143.7246871657726,47.77940321379391,40.145111825865804,40.78601923135148
1513987200,14229.47,16261,13750,15075.89,30793.21416,40392.04050550001,30793.21416,40392.04050550001,51.54646906689202,1259059.2894000001,2053407.1141760105,2053407.1141760105,1259059.2894000001,54.47244932109988,57.142857142857146,92.85714285714286,-604.340415909727,1388.2991672786138,1992.6395831883408,51.54646906689202,49.26142990036861,41.57813390971494
1514073600,15075.89,15109.27,13210,14221.94,24834.82068,40624.74221250001,24834.82068,40624.74221250001,47.87601525881452,1234224.4687200002,2055036.5123157878,2055036.5123157878,1234224.4687200002,52.178905203047854,50,85.71428571428571,-694.1600869812789,1124.939474461742,1819.099561443021,47.87601525881452,40.264897034236235,43.22381292015691
1514160000,14221.93,14774,13450,14171.98,15425.34696,40510.43615400001,15425.34696,40510.43615400001,47.66218485388574,1218799.1217600002,2056434.1139935232,2056434.1139935232,1218799.1217600002,50.04918566485668,42.857142857142854,78.57142857142857,-733.8410118584984,901.7982966198979,1635.6393084783963,47.66218485388574,39.738558510912874,43.08829514850593
1514246400,14171.99,16148,14171.98,15790.88,22462.56402,39065.904216500014,22462.56402,39065.904216500014,54.719576491947464,1241261.6857800002,2070777.4981845515,2070777.4981845515,1241261.6857800002,47.19302917559736,35.714285714285715,71.42857142857143,-631.8404837728074,845.838703762387,1477.6791875351944,54.719576491947464,56.79399156551996,45.59914903688971
1514332800,15790.88,16490,14524.37,15367.08,24953.26288,36087.91176700001,24953.26288,36087.91176700001,52.715596561234996,1216308.4229000001,2067220.2906777447,2067220.2906777447,1216308.4229000001,44.33461194601848,28.571428571428573,64.28571428571429,-575.3040516356027,758.5491229906911,1333.8531746262938,52.715596561234996,52.329174388089314,49.620574821507404
1514419200,15360.01,15489,13500,14450.01,31266.75624,34226.40499850001,31266.75624,34226.40499850001,48.57037002083338,1185041.66666,2065821.5395614877,2065821.5395614877,1185041.66666,42.197730271351034,21.428571428571427,57.142857142857146,-580.3954719732774,608.3588346596971,1188.7543066329745,48.57037002083338,42.667659784723746,50.59694191277769
1514505600,14450.01,15105.34,14041.81,14565.05,18474.94783,33091.72254250001,18474.94783,33091.72254250001,49.11095566631529,1203516.61449,2065525.3581086828,2065525.3581086828,1203516.61449,40.21348300201698,14.285714285714286,50,-556.6574479596179,492.932496683452,1049.5899446430699,49.11095566631529,43.87962903458599,46.292154402466366
1514592000,14565.04,14639.79,12500,12839.99,28780.68957,31887.19130800001,28780.68957,31887.19130800001,41.984408496655334,1174735.9249200001,2045890.562899255,2045890.562899255,1174735.9249200001,39.103788502798494,7.142857142857143,42.857142857142854,-632.2562214564732,259.26966782247837,891.5258892789516,41.984408496655334,25.70577929390991,37.41768937107324
1514678400,12839.98,14280.26,12633.8,13863.13,18604.18399,30759.21782650001,18604.18399,30759.21782650001,46.90554579281908,1193340.1089100002,2055068.021347488,2055068.021347488,1193340.1089100002,38.073357896381346,0,35.714285714285715,-589.3296190069043,154.86386552032127,744.1934845272256,46.90554579281908,38.5434613244296,36.04295655097519
1514764800,13863.14,13889,12952.5,13480.01,12292.15331,29462.88325050001,12292.15331,29462.88325050001,45.35415130065103,1181047.9556000002,2056623.6711182315,2056623.6711182315,1181047.9556000002,37.11652947613685,0,28.571428571428573,-562.7649170748666,40.73733818364235,603.502255258509,45.35415130065103,35.406483503851014,33.21857470739687
1514851200,13480,15275,13005,14781.51,26387.79414,29190.06273750001,26387.79414,29190.06273750001,51.2526694684349,1207435.74974,2071538.2383594222,2071538.2383594222,1207435.74974,35.17159092234404,0,21.428571428571427,-439.05693507373087,54.68108641634535,493.7380214900762,51.2526694684349,58.498130841121494,44.1493585564674
1514937600,14781.52,15400,14628,15098.14,17867.70214,29266.982669000008,17867.70214,29266.982669000008,52.59332682953442,1225303.45188,2075433.0271108719,2075433.0271108719,1225303.45188,33.276170670768934,0,14.285714285714286,-322.79780693459134,90.24076282183705,413.0385697564284,52.59332682953442,67.45771813622376,53.787444160398785
1515024000,15098.23,15400,14230,15144.99,20010.43497,28837.239450500005,20010.43497,28837.239450500005,52.8001739951816,1245313.8868500001,2086720.622727539,2086720.622727539,1245313.8868500001,31.76144625084472,0,7.142857142857143,-233.78297954146655,120.80984532959519,354.59282487106174,52.8001739951816,77.9144499178982,67.95676629841451
1515110400,15145,17178,14819.78,16960.01,22917.01766,28741.084583000007,22917.01766,28741.084583000007,60.06917715892866,1268230.90451,2105400.8171227854,2105400.8171227854,1268230.90451,29.856562304410467,100,0,-53.137339055816994,288.1711510512905,341.3084901071075,60.06917715892866,95.34010260795208,80.2374235540247
1515196800,16960.01,17174,16251.01,17098.99,14104.18147,28372.898627000006,14104.18147,28372.898627000006,60.56992335314691,1282335.08598,2117212.547640847,2117212.547640847,1282335.08598,28.087741497007222,92.85714285714286,50,68.63113039468692,427.0974031004662,358.46627270577926,60.56992335314691,98.31103035485253,90.52186096023429
1515283200,17099,17115.01,15755.01,16174.22,12341.07086,27670.759259000002,12341.07086,27670.759259000002,55.57577927621029,1269994.0151199999,2112479.565479701,2112479.565479701,1269994.0151199999,26.090884953708443,85.71428571428571,42.857142857142854,79.07076118440244,457.30472418628233,378.2339630018799,55.57577927621029,78.54253954681487,90.73122416987319
1515369600,16174.22,16275,14000,14993.74,23150.46763,27220.992116,23150.46763,27220.992116,49.917709759281145,1246843.5474899998,2109553.753412458,2109553.753412458,1246843.5474899998,25.30829595186546,78.57142857142857,35.714285714285715,2.6853369289570423,381.5906341630762,378.90529723411913,49.917709759281145,53.30782385634886,76.72046458600545
1515456000,14993.73,15384,14230,14480.99,15382.53099,25591.163514500004,15382.53099,25591.163514500004,47.64855472468174,1231461.0165,2100862.4901056127,2100862.4901056127,1231461.0165,24.581606164439833,71.42857142857143,28.571428571428573,-81.5092513526393,277.01873304332,358.5279843959593,47.64855472468174,42.346943138093195,58.06576884708566
1515542400,14481,14875.18,13550.01,14875.18,22654.63169,25287.015347000004,22654.63169,25287.015347000004,49.547349891939746,1254115.6481899999,2123517.121795613,2123517.121795613,1254115.6481899999,24.295492293367996,64.28571428571429,21.428571428571427,-108.12028482024436,223.37762837065384,331.4979131908982,49.547349891939746,50.773407439076536,48.80939147783956
1515628800,14875.17,14970,12800.01,13308.06,28879.86652,21579.181885500006,28879.86652,21579.181885500006,42.88753894162104,1225235.78167,2108160.281819962,2108160.281819962,1225235.78167,24.431299508293357,57.142857142857146,14.285714285714286,-222.16386158489303,53.793086209781904,275.95694779467493,42.88753894162104,17.273621205643426,36.79799059427108
1515715200,13308.06,14080.83,12900,13820,14816.74722,20780.358538500008,14816.74722,20780.358538500008,45.466282005294616,1240052.52889,2116431.3752584816,2116431.3752584816,1240052.52889,24.557406207866904,50,7.142857142857143,-251.8430013797753,-38.84680393004419,212.9961974497311,45.466282005294616,28.21718683197948,32.088071825566495
1515801600,13820,14500,13792.25,14187.95,10490.82383,20063.158696000006,10490.82383,20063.158696000006,47.30780814898062,1250543.3527199998,2117671.3009573575,2117671.3009573575,1250543.3527199998,24.27915210663816,42.857142857142854,0,-235.70342121261066,-81.63307906603222,154.07034214657844,47.30780814898062,34.20073940407555,26.563849147232833
1515888000,14187.94,14332.85,13110,13656.23,10783.39315,19831.061005500007,10783.39315,19831.061005500007,44.94580322257679,1239759.95957,2116521.4897517078,2116521.4897517078,1239759.95957,24.425340300802798,35.714285714285715,0,-248.5692403230974,-156.64120825729333,91.92803206580408,44.94580322257679,19.55737678706437,27.325101007706483
1515974400,13656.23,14253,13416,13590,10511.68508,19233.51705850001,10511.68508,19233.51705850001,44.64678708610908,1229248.27449,2110380.2543823887,2110380.2543823887,1229248.27449,24.56108648109853,28.571428571428573,71.42857142857143,-248.66761036575522,-218.90648089138995,29.76112947436527,44.64678708610908,18.044582102745775,23.93423276462858
1516060800,13590,13643.66,9928.62,11570.01,62196.53504,21095.68066650001,62196.53504,21095.68066650001,36.64027517453375,1167051.73945,2103143.4347959533,2103143.4347959533,1167051.73945,26.25200675407179,21.428571428571427,100,-364.8760690351931,-426.3339568196261,-61.457887784433005,36.64027517453375,22.641798333098826,20.081252407636338
1516147200,11570.01,12358.89,9005,11200.01,63957.2302,22730.20436450001,63957.2302,22730.20436450001,35.38842719677285,1103094.50925,2122901.9852931746,2122901.9852931746,1103094.50925,28.111235618088127,14.285714285714286,100,-441.6381089101744,-613.505523922151,-171.86741501197662,35.38842719677285,26.856845711489054,22.514408715777904
1516233600,11204.64,12123.1,10687.21,11305.53,30134.64184,23313.189065000006,30134.64184,23313.189065000006,36.05937308750855,1133229.1510899998,2118720.378494172,2118720.378494172,1133229.1510899998,29.83766242038901,7.142857142857143,92.85714285714286,-458.2987466324254,-744.7408483025083,-286.44210167008293,36.05937308750855,28.14792609812799,25.88219004757197
1516320000,11305.53,11973.99,11050,11498.99,15959.30877,22672.120025000007,15959.30877,22672.120025000007,37.34401135758655,1149188.4598599998,2118271.129453481,2118271.129453481,1149188.4598599998,31.440773022525548,0,85.71428571428571,-429.75893077919073,-823.6407651440713,-393.8818343648806,37.34401135758655,30.529930224017622,28.511567344544904
1516406400,11499,12985.55,11498.99,12762.8,18749.8904,22679.405345500007,18749.8904,22679.405345500007,45.1033561012373,1167938.3502599997,2131401.95558887,2131401.95558887,1167938.3502599997,31.878483476548645,0,78.57142857142857,-305.0977066082031,-775.2539676251345,-470.15626101693135,45.1033561012373,46.33533127579374,35.0043958659798
1516492800,12762.8,12762.8,11118,11518.17,16425.31152,22886.063256000005,16425.31152,22886.063256000005,39.867106526906014,1151513.0387399998,2122969.0041259695,2122969.0041259695,1151513.0387399998,32.453090504791184,0,71.42857142857143,-286.1117944872283,-827.7960041259666,-541.6842096387384,39.867106526906014,34.56905089408528,37.14477079796557
1516579200,11518.17,11849,10025,10766.7,24352.47028,22784.297063000005,24352.47028,22784.297063000005,37.0689151027098,1127160.5684599997,2118421.6075375,2118421.6075375,1127160.5684599997,33.4344330870801,0,64.28571428571429,-302.2319678318911,-919.4741694286022,-617.2422015967111,37.0689151027098,27.617181376391294,36.173854515423464
1516665600,10766.7,11370,9945,10824.94,21897.00224,22985.762068000004,21897.00224,22985.762068000004,37.43542491502172,1149057.5706999998,2123567.479895487,2123567.479895487,1149057.5706999998,34.37703428400859,0,57.142857142857146,-287.14826094473847,-976.1775277776342,-689.0292668328957,37.43542491502172,30.510310142497914,30.898847470991516
1516752000,10824.95,11450,10450,11356.79,15159.46299,22743.213469000002,15159.46299,22743.213469000002,40.82474810665989,1164217.0336899997,2135900.9157948913,2135900.9157948913,1164217.0336899997,35.16109240070918,7.142857142857143,50,-222.41812655607134,-967.0519250279849,-744.6337984719136,40.82474810665989,39.426487845766985,32.51799312155209
1516838400,11356.8,11690,10851,11118,13801.78961,22287.452066500002,13801.78961,22287.452066500002,39.78269386174002,1150415.2440799996,2130883.578689945,2130883.578689945,1150415.2440799996,35.60501459250933,0,42.857142857142854,-178.6373423701781,-967.9304764346361,-789.2931340644581,39.78269386174002,38.45313921747043,36.129979068578464
1516924800,11118,11570,10305,11086.89,19343.27196,22549.406591,19343.27196,22549.406591,39.64073025692295,1131071.9721199996,2135452.260742284,2135452.260742284,1131071.9721199996,36.28034615614668,7.142857142857143,35.714285714285715,-136.62146302683334,-960.0699628479997,-823.4484998211664,39.64073025692295,37.886988171064594,38.58887174476735
1517011200,11086.88,11494.08,10850,11319,12301.08533,22547.4073145,12301.08533,22547.4073145,41.323126612891755,1143373.0574499995,2141065.748197559,2141065.748197559,1143373.0574499995,36.9074397509528,0,28.571428571428573,-80.804860250032,-924.4545751337064,-843.6497148836744,41.323126612891755,43.43215368300534,39.92409369051347
1517097600,11319,11697.24,11234.38,11536,13684.86906,22074.127386,13684.86906,22074.127386,42.924830098918825,1157057.9265099994,2145216.2082041325,2145216.2082041325,1157057.9265099994,37.21620300609185,0,21.428571428571427,-20.04434421833787,-868.7051451565967,-848.6608009382588,42.924830098918825,48.22789634146341,43.1823460651778
1517184000,11536,11570,10840,11123.01,11162.53596,21863.1276345,11162.53596,21863.1276345,40.65053950207331,1145895.3905499994,2142708.7662223233,2142708.7662223233,1145895.3905499994,37.72247334490168,0,14.285714285714286,0.47094929617082926,-848.0721143180454,-848.5430636142162,40.65053950207331,45.65995352105997,45.77333451517626
1517270400,11123.01,11150,9711.11,9995,27583.83797,22109.587948499997,27583.83797,22109.587948499997,35.1695138658752,1118311.5525799994,2126009.395808986,2126009.395808986,1118311.5525799994,38.74494909611326,0,7.142857142857143,-50.94610794112907,-912.2256985406275,-861.2795905994984,35.1695138658752,24.870934921053628,39.58626159452569
1517356800,9995,10299.95,9601.02,10099.99,19533.03021,21642.246133,19533.03021,21642.246133,36.034012473184205,1137844.5827899994,2134365.842610657,2134365.842610657,1137844.5827899994,39.74362916401776,21.428571428571427,0,-65.95030599289794,-943.7174730906208,-877.7671670977229,36.034012473184205,14.742667371835957,28.424518604649876
1517443200,10099.99,10166.25,8400,9014.23,38152.39046,22809.028295,38152.39046,22809.028295,31.37457529117316,1099692.1923299995,2122749.1552416645,2122749.1552416645,1099692.1923299995,41.1587757226703,14.285714285714286,100,-133.18565358949888,-1044.2492340845965,-911.0635804950977,31.37457529117316,13.394903555734855,17.669501949541505
1517529600,9014.22,9090.08,7540,8787.52,52037.55236,24886.364721500002,52037.55236,24886.364721500002,30.4880879320812,1047654.6399699996,2154472.295646099,2154472.295646099,1047654.6399699996,42.762404318721856,7.142857142857143,100,-174.5077646653433,-1129.1982863267767,-954.6905216614334,30.4880879320812,22.90898072738292,17.015517218317935
1517616000,8787.52,9499,8115.48,9240,23684.29438,25531.409783,23684.29438,25531.409783,34.46789660015902,1071338.9343499995,2169289.0171042476,2169289.0171042476,1071338.9343499995,43.680952431863865,0,92.85714285714286,-153.6797301853619,-1146.7901843931359,-993.110454207774,34.46789660015902,32.54959025809911,22.951158180405653
1517702400,9227.8,9350,7859,8167.91,24059.18803,26208.784930499998,24059.18803,26208.784930499998,30.07434548049777,1047279.7463199996,2155199.143325552,2155199.143325552,1047279.7463199996,44.635082962813485,0,85.71428571428571,-191.93325703871938,-1233.0270255061732,-1041.0937684674539,30.07434548049777,14.572058482246458,23.34354315590952
1517788800,8167.9,8349.16,6425.75,6905.19,59575.37153,26077.726755,59575.37153,26077.726755,25.88862365963125,987704.3747899996,2125323.956494959,2125323.956494959,987704.3747899996,46.015593466859954,0,100,-276.94075538382003,-1387.269712697229,-1110.3289573134089,25.88862365963125,9.094961766028193,18.738870168791276
1517875200,6905.2,7948.89,5873,7688.46,91890.49578,27474.390034,91890.49578,27474.390034,32.19294281758236,1079594.8705699996,2194158.2770286934,2194158.2770286934,1079594.8705699996,47.4589803945959,35.714285714285715,100,-255.59499775834183,-1429.8227045113363,-1174.2277067529944,32.19294281758236,31.170762193865638,18.279260814046783
1517961600,7688.47,8650,7212.82,7575.75,50891.54974,28512.235429,50891.54974,28512.235429,31.774089397560275,1028703.3208299995,2168969.9379472584,2168969.9379472584,1028703.3208299995,47.86214037253543,28.571428571428573,92.85714285714286,-225.3048573082906,-1455.8587783883577,-1230.553921080067,31.774089397560275,29.23557408348557,23.16709934779315
1518048000,7575.76,8625,7550,8218.1,31646.91253,29296.615616999996,31646.91253,29296.615616999996,36.81930519962721,1060350.2333599995,2176659.4017173382,2176659.4017173382,1060350.2333599995,48.23650320919356,21.428571428571427,85.71428571428571,-142.29672961330516,-1408.4248330966984,-1266.1281034833933,36.81930519962721,40.26448085930525,33.55693904555218
1518134400,8218.07,8700,7750,8671.01,27554.32195,29736.837194499996,27554.32195,29736.837194499996,40.17833434679885,1087904.5553099995,2202532.0398919056,2202532.0398919056,1087904.5553099995,48.478077350817436,14.285714285714286,78.57142857142857,-42.3627072516847,-1319.0814875479991,-1276.7187802963144,40.17833434679885,48.040774418636595,39.18027645380916
1518220800,8671,9090,8155,8547.49,24876.86492,30159.414864499995,24876.86492,30159.414864499995,39.56059922717105,1063027.6903899994,2198540.5668701963,2198540.5668701963,1063027.6903899994,48.14457574481018,7.142857142857143,71.42857142857143,26.251568617077965,-1243.904319524967,-1270.155888142045,39.56059922717105,45.91998269302089,44.74174599032093
1518307200,8547.48,8547.49,7851,8072.99,16803.7684,29781.97977049999,16803.7684,29781.97977049999,37.19480858616543,1046223.9219899995,2192448.419734295,2192448.419734295,1046223.9219899995,48.00124414501677,0,64.28571428571429,49.17980414593376,-1208.6811329596276,-1257.8609371055613,37.19480858616543,38.616640337019476,44.19246581622567
1518393600,8073,8950,8072.99,8872.28,19717.6203,29673.010673499986,19717.6203,29673.010673499986,43.34137176322175,1065941.5422899995,2208671.317169753,2208671.317169753,1065941.5422899995,47.28568892165406,0,57.142857142857146,123.44918995448279,-1103.5494496624578,-1226.9986396169406,43.34137176322175,56.83683911313247,47.124487381057634
1518480000,8872.27,8925,8393.1,8520.01,13952.54756,29612.664901999982,13952.54756,29612.664901999982,41.417497756615624,1051988.9947299995,2201376.855004901,2201376.855004901,1051988.9947299995,46.621244785674406,0,50,152.23365556557246,-1036.706570159975,-1188.9402257255474,41.417497756615624,59.793085532928984,51.74885499436033
1518566400,8520.01,9482.5,8520,9472.98,24369.27755,30141.039298999985,24369.27755,30141.039298999985,48.12581392101874,1076358.2722799995,2225264.063937185,2225264.063937185,1076358.2722799995,45.19350796977581,0,42.857142857142854,233.950521361455,-896.5020740237287,-1130.4525953851837,48.12581392101874,83.85209340243404,66.82733934949852
1518652800,9472.98,10249.81,9342.46,10031.23,32371.05692,30792.42854699998,32371.05692,30792.42854699998,51.620747638917116,1108729.3291999993,2242038.789515203,2242038.789515203,1108729.3291999993,42.884750864960345,100,35.714285714285715,318.8373281628121,-731.9059351816686,-1050.7432633444807,51.620747638917116,95.00595182335994,79.55037691957433
1518739200,10031.23,10307.68,9729.58,10167.49,17843.54592,31069.55157649998,17843.54592,31069.55157649998,52.4626218566093,1126572.8751199993,2251228.169365233,2251228.169365233,1126572.8751199993,40.6703642041658,100,28.571428571428573,373.6039751736522,-583.7382943774155,-957.3422695510677,52.4626218566093,96.83877979921888,91.89894167500431
1518825600,10167.49,11149,10057,11121.5,20773.70417,31423.993331999976,20773.70417,31423.993331999976,57.97641401990238,1147346.5792899993,2270955.578911286,2270955.578911286,1147346.5792899993,37.87938279164077,100,21.428571428571427,457.9563069735193,-384.89688583416864,-842.853192807688,57.97641401990238,99.47877179681576,97.10783447313156
1518912000,11121.5,11299.1,10159,10380.04,26974.2742,32214.580243999975,26974.2742,32214.580243999975,52.84606076757595,1120372.3050899992,2254440.7268131506,2254440.7268131506,1120372.3050899992,35.446784098287615,100,14.285714285714286,447.185774679054,-283.8709744588705,-731.0567491379245,52.84606076757595,83.06223622859882,93.12659594154452
1518998400,10380.03,11274.11,10297.39,11140,17633.25671,31717.051180999977,17633.25671,31717.051180999977,57.041986571236095,1138005.5617999993,2267231.6621672283,2267231.6621672283,1138005.5617999993,33.18794245445969,92.85714285714286,7.142857142857143,472.15657307895185,-140.86103278923474,-613.0176058681866,57.041986571236095,97.06787563811945,93.20296122117804
1519084800,11140,11775,11000,11235.57,28425.11658,32161.65549949998,28425.11658,32161.65549949998,57.55351187257072,1166430.6783799992,2256086.8158136816,2256086.8158136816,1166430.6783799992,31.643552830514686,100,0,474.7443766177066,-19.587135096053316,-494.33151171375994,57.55351187257072,88.17604741592834,89.4353864275489
1519171200,11235.57,11279.99,10250,10454.27,30033.2259,31755.697271499976,30033.2259,31755.697271499976,52.09243248793282,1136397.4524799993,2237966.1076169466,2237966.1076169466,1136397.4524799993,29.472840405995836,92.85714285714286,0,406.12546233350224,13.325316203117836,-392.8001461303844,52.09243248793282,68.74011834319528,84.66134713241438
1519257600,10453.83,10900,9715.27,9830,28095.85652,30558.612479499978,28095.85652,30558.612479499978,48.16024118965719,1108301.5959599994,2215311.8920084448,2215311.8920084448,1108301.5959599994,28.029035642984695,85.71428571428571,0,305.5683193652844,-10.839746923778875,-316.4080662890633,48.16024118965719,51.67701863354037,69.53106146422135
1519344000,9830,10390.77,9576.43,10144.99,20776.53619,30413.22456999998,20776.53619,30413.22456999998,50.20279701477875,1129078.1321499993,2223547.0890408983,2223547.0890408983,1129078.1321499993,26.832039614607133,78.57142857142857,0,249.50921190886328,-4.521551402984187,-254.03076331184747,50.20279701477875,58.460499490315996,59.625878822350565
1519430400,10144.99,10494.14,9372.72,9688.62,19727.94904,30196.66262049998,19727.94904,30196.66262049998,47.29520744495852,1109350.1831099992,2214933.725261971,2214933.725261971,1109350.1831099992,25.93502526431019,71.42857142857143,7.142857142857143,174.48424696032248,-35.925454611444366,-210.40970157176685,47.29520744495852,46.830275229357824,52.32259778440474
1519516800,9688.61,9850,9324.75,9597.99,11707.16068,27803.25207799998,11707.16068,27803.25207799998,46.71655792124061,1097643.0224299992,2215406.9152119686,2215406.9152119686,1097643.0224299992,25.15418721444625,64.28571428571429,0,114.44777007223291,-67.34998898147569,-181.7977590537086,46.71655792124061,41.193837942090916,48.828204220588255
1519603200,9600,10447.74,9404,10300,19118.77984,24164.666280999976,19118.77984,24164.666280999976,51.65104028854494,1116761.8022699992,2229113.2196585536,2229113.2196585536,1116761.8022699992,23.587270069129307,57.142857142857146,0,117.2765818792513,-35.20203170464447,-152.47861358389576,51.65104028854494,56.38546379254265,48.136525654663814
1519689600,10300,10845.07,10133.33,10566.57,18216.01842,22530.889714999976,18216.01842,22530.889714999976,53.41523256968978,1134977.8206899993,2233073.579748349,2233073.579748349,1134977.8206899993,22.176567889593656,50,0,131.30378716253978,11.651120369278942,-119.65266679326082,53.41523256968978,62.87465437788018,53.484652037504596
1519776000,10556.3,11044,10263,10307.27,19669.31713,21932.009944999976,19669.31713,21932.009944999976,51.44866522380816,1115308.5035599992,2215634.1234873505,2215634.1234873505,1115308.5035599992,21.110762812785254,42.857142857142854,0,117.75553648524914,27.541753813300602,-90.21378267194854,51.44866522380816,40.09876543209878,53.11962786750721
1519862400,10307.26,11075,10213.99,10895.92,15390.55107,21323.821400999972,15390.55107,21323.821400999972,55.45783406472434,1130699.0546299992,2224622.5656721676,2224622.5656721676,1130699.0546299992,20.04951659673337,35.714285714285715,71.42857142857143,141.4795452721944,86.63564891829446,-54.843896353899936,55.45783406472434,64.1228446076931,55.6987548058907
1519948800,10895.93,11149,10765,11000,13837.31985,20771.84414749997,13837.31985,20771.84414749997,56.1473492592853,1144536.3744799993,2227721.5487635736,2227721.5487635736,1144536.3744799993,19.16427023427577,28.571428571428573,64.28571428571429,156.07484660681567,140.24966190461964,-15.825184702196019,56.1473492592853,68.37057443118049,57.53072815699081
1520035200,11000.01,11494.57,11000,11432.5,13198.01803,20591.55662899997,13198.01803,20591.55662899997,58.9884229044203,1157734.3925099992,2237606.7860785197,2237606.7860785197,1157734.3925099992,18.80387537156965,21.428571428571427,57.142857142857146,184.7866121541035,215.15808049043335,30.371468336329862,58.9884229044203,86.02183450668299,72.83841784851889
1520121600,11432.51,11487,11041,11469.9,8633.59444,20037.35533599997,8633.59444,20037.35533599997,59.234375221257615,1166367.9869499991,2245578.3425592193,2245578.3425592193,1166367.9869499991,18.46922299905683,14.285714285714286,50,195.20566075265575,274.37854427714956,79.17288352449381,59.234375221257615,87.54820936639118,80.6468727680849
1520208000,11469.9,11645.74,11339,11377.54,11051.42859,19892.299387499974,11051.42859,19892.299387499974,58.30446026583321,1155316.5583599992,2237304.002434099,2237304.002434099,1155316.5583599992,18.378968114262964,7.142857142857143,42.857142857142854,184.88711176847875,310.28177323509226,125.39466146661351,58.30446026583321,83.77879808182843,85.78294731830088
1520294400,11371.5,11395.63,10565.85,10700,18305.57838,19589.114428999972,18305.57838,19589.114428999972,51.87119614298368,1137010.9799799991,2224917.3262683656,2224917.3262683656,1137010.9799799991,17.165206588595506,0,35.714285714285715,124.34533812246178,280.8263341196907,156.48099599722894,51.87119614298368,59.2527326701106,76.85991337277675
1520380800,10700,10894,9400,9920,32412.54885,19591.189025499974,32412.54885,19591.189025499974,45.629284613643065,1104598.4311299992,2215067.729763747,2215067.729763747,1104598.4311299992,17.480948693080272,85.71428571428571,28.571428571428573,28.67615404619943,192.32618855497822,163.6500345087788,45.629284613643065,25.646383655250563,56.22597146906321
1520467200,9925,10098,9050,9304.9,23320.34426,19865.028942499972,23320.34426,19865.028942499972,41.39858093390077,1081278.0868699993,2203091.575869919,2203091.575869919,1081278.0868699993,18.12201716019182,78.57142857142857,100,-73.53689963373176,71.72890996661408,145.26580960034585,41.39858093390077,9.819935740867717,31.573017355409633
1520553600,9304.9,9410,8370,9255,41958.06001,20924.246734499975,41958.06001,20924.246734499975,41.0659289622393,1039320.0268599993,2232542.906453861,2232542.906453861,1039320.0268599993,19.321446419738674,71.42857142857143,100,-138.2559977734627,-27.554187616482523,110.70181015698017,41.0659289622393,27.016796204827003,20.827705200315105
1520640000,9255,9518.77,8720.08,8795.44,16527,20401.883024499977,16527,20401.883024499977,38.034750040251545,1022793.0268599993,2219134.700278749,2219134.700278749,1022793.0268599993,20.247995966977324,64.28571428571429,92.85714285714286,-201.91035966580313,-141.68613942527372,60.22422024052939,38.034750040251545,12.987599748453801,16.608110564716178
1520726400,8795.45,9760,8516,9533.88,21059,20573.170188999975,21059,20573.170188999975,45.05303942002619,1043852.0268599993,2232537.975069746,2232537.975069746,1043852.0268599993,20.68936684181635,57.142857142857146,85.71428571428571,-184.6467428658978,-170.5842083418429,14.062534524054925,45.05303942002619,35.53029239194805,25.178229448409624
1520812800,9533.88,9890,8782.69,9120,20338,20168.81435999998,20338,20168.81435999998,42.1701242959222,1023514.0268599993,2224590.7432918334,2224590.7432918334,1023514.0268599993,20.872655095774594,50,78.57142857142857,-190.68781507605587,-224.2972343210149,-33.60941924495904,42.1701242959222,22.895590004090682,23.804494048164184
1520899200,9120,9472.88,8855,9145.41,16707,19502.503064999975,16707,19502.503064999975,42.41376025645196,1040221.0268599993,2223588.6693939893,2223588.6693939893,1040221.0268599993,21.04285133159296,42.857142857142854,71.42857142857143,-182.55005424201448,-261.79698704747716,-79.24693280546268,42.41376025645196,23.671292593429268,27.365724996489337
1520985600,9145.42,9340,7931,8207.03,26742,19434.810238999977,26742,19434.810238999977,36.327105269090104,1013479.0268599993,2207324.446909958,2207324.446909958,1013479.0268599993,22.140276470580936,35.714285714285715,100,-227.0426281265743,-363.05021796368055,-136.00758983710625,36.327105269090104,7.430668095209912,17.999183564243292
1521072000,8207.02,8400,7666,8259.99,27141,19753.033429499978,27141,19753.033429499978,36.87767057691716,1040620.0268599993,2224111.192386797,2224111.192386797,1040620.0268599993,23.38764614690921,28.571428571428573,100,-238.4080230257072,-434.01761861924024,-195.60959559353304,36.87767057691716,14.925346881957108,15.342435856865436
1521158400,8260,8600,7911,8275,16412,19587.23597749998,16412,19587.23597749998,37.04382426509536,1057032.0268599992,2225040.173518873,2225040.173518873,1057032.0268599992,24.15450914421585,21.428571428571427,92.85714285714286,-230.29265136826245,-483.4754098038611,-253.18275843559866,37.04382426509536,15.302507198962747,12.552840725376596
1521244800,8274.09,8349.82,7751,7865.02,13133,19658.52794349998,13133,19658.52794349998,34.38174179707616,1043899.0268599992,2216908.424846484,2216908.424846484,1043899.0268599992,25.02051598955869,14.285714285714286,85.71428571428571,-236.98951924060464,-549.4196574863545,-312.43013824574984,34.38174179707616,5.000829199897492,11.742894426939122
1521331200,7857.59,8302.73,7310,8192,29821,20193.638951499983,29821,20193.638951499983,38.19645819227204,1073720.0268599992,2240076.9023479195,2240076.9023479195,1073720.0268599992,26.22748402169423,7.142857142857143,100,-205.04813843006912,-568.7403112833363,-363.69217285326715,38.19645819227204,20.34254821552953,13.548628204796595
1521417600,8192,8757.5,8108.31,8589,24483,20506.988030499982,24483,20506.988030499982,42.56249249855736,1098203.0268599992,2251850.5707192747,2251850.5707192747,1098203.0268599992,26.44107829439658,0,92.85714285714286,-145.62761285012084,-545.7266889159182,-400.09907606579736,42.56249249855736,31.30484160337574,18.88273967293426
1521504000,8589,9046.26,8316.15,8900,19838,20515.422173999985,19838,20515.422173999985,45.793091011372006,1118041.0268599992,2263740.4372051465,2263740.4372051465,1118041.0268599992,26.107179225033196,0,85.71428571428571,-77.25501812806579,-496.6678487258796,-419.4128305978138,45.793091011372006,44.363839285714285,32.00374303487319
1521590400,8900,9174,8745,8891.81,15326,20512.194620499984,15326,20512.194620499984,45.72016149136911,1102715.0268599992,2258903.994594424,2258903.994594424,1102715.0268599992,25.564580869081414,0,78.57142857142857,-27.04952459438499,-453.22473634079506,-426.17521174641007,45.72016149136911,56.7363701578192,44.135017015636414
1521676800,8891.81,9073.93,8467.27,8715.09,14514,20546.028627999982,14514,20546.028627999982,44.08855383680612,1088201.0268599992,2256247.903406609,2256247.903406609,1088201.0268599992,25.40366255331506,0,71.42857142857143,-1.5562126071069997,-428.1204775052938,-426.5642648981868,44.08855383680612,54.4608527131783,51.8536873855706
1521763200,8715.09,8927.81,8280.04,8927.1,15043,20638.277726499982,15043,20638.277726499982,46.55282264088587,1103244.0268599992,2271257.9271032913,2271257.9271032913,1103244.0268599992,25.478923066785082,21.428571428571427,64.28571428571429,31.922968580489567,-386.66055417257485,-418.5835227530644,46.55282264088587,62.67829457364342,57.95850581488031
1521849600,8927.8,8999,8508,8531.34,11103,20761.748004499983,11103,20761.748004499983,42.76382662588615,1092141.0268599992,2261210.5035595032,2261210.5035595032,1092141.0268599992,25.399602996255016,14.285714285714286,57.142857142857146,29.793283430060683,-381.34191846548856,-411.13520189554924,42.76382662588615,47.33875968992248,54.82596899224808
1521936000,8531.96,8670,8359.45,8452.96,8872,20652.77657499998,8872,20652.77657499998,42.03413677133727,1083269.0268599992,2257681.415940762,2257681.415940762,1083269.0268599992,25.519301874644846,7.142857142857143,50,25.64283755501509,-379.08165495178037,-404.72449250679546,42.03413677133727,44.300775193798415,51.439276485788106
1522022400,8453,8498,7854,8145,19001,20687.54765599998,19001,20687.54765599998,39.203644792042255,1064268.0268599992,2255852.1271208865,2255852.1271208865,1064268.0268599992,26.234389359082765,0,42.857142857142854,5.733686764414756,-397.55738405127704,-403.2910708156918,39.203644792042255,38.605932830300354,43.41515590467376
1522108800,8144.99,8219.99,7757,7793.61,14738,19803.82021349998,14738,19803.82021349998,36.20765732431101,1049530.0268599992,2243444.8823423814,2243444.8823423814,1049530.0268599992,27.006161517810863,0,35.714285714285715,-25.793713759194816,-435.5332130146853,-409.7394992554905,36.20765732431101,23.82315270935959,35.57662024448613
1522195200,7793.61,8088,7727.76,7942.72,10790,19177.303000499982,10790,19177.303000499982,38.36031998564146,1060320.0268599992,2245531.955404784,2245531.955404784,1060320.0268599992,27.756713886550223,0,28.571428571428573,-30.950959868617417,-448.4281990912623,-417.47723922264487,38.36031998564146,33.944206008583706,32.124430516081226
1522281600,7942.73,7957,6905,7079.99,27190,18438.89999999998,27190,18438.89999999998,31.695887702356586,1033130.0268599992,2227387.541146229,2227387.541146229,1033130.0268599992,29.283729038741097,42.857142857142854,100,-83.81227416200215,-522.2425819251475,-438.4303077631454,31.695887702356586,7.712208021154684,21.826522246366
1522368000,7080,7275.35,6600,6848.01,28894,19057.249999999978,28894,19057.249999999978,30.177693565684066,1004236.0268599992,2219715.1327357753,2219715.1327357753,1004236.0268599992,30.952779653223732,35.714285714285715,100,-123.35848018799032,-592.6284079981333,-469.269927810143,30.177693565684066,9.635198135198143,17.097204054978857
1522454400,6848.01,7200,6780,6928.5,14730,18740.79999999998,14730,18740.79999999998,31.405388482907355,1018966.0268599992,2215401.3470214894,2215401.3470214894,1018966.0268599992,32.502612366671904,28.571428571428573,92.85714285714286,-132.26369249928882,-634.599543434254,-502.33585093496515,31.405388482907355,12.762237762237762,10.03654797286354
1522540800,6928.5,7044.46,6450,6816.01,15144,18481.09999999998,15144,18481.09999999998,30.595708406078643,1003822.0268599992,2218905.718451022,2218905.718451022,1003822.0268599992,34.21165335599884,21.428571428571427,100,-133.51097467452303,-669.2245692781189,-535.7135946035959,30.595708406078643,13.43649045521293,11.944642117549622
1522627200,6816.01,7100,6777.28,7045.01,14078,18349.64999999998,14078,18349.64999999998,34.308695326472744,1017900.0268599992,2228186.065872936,2228186.065872936,1017900.0268599992,35.63930322807586,14.285714285714286,92.85714285714286,-107.79563747169891,-670.4581414432196,-562.6625039715207,34.308695326472744,21.84324522760647,16.0139911483524
1522713600,7045.01,7520,7016.8,7424.9,18668,17945.94999999998,18668,17945.94999999998,40.039425270734895,1036568.0268599992,2239797.9180191997,2239797.9180191997,1036568.0268599992,35.81908924828662,7.142857142857143,85.71428571428571,-56.65355790813862,-633.479451356694,-576.8258934485553,40.039425270734895,35.7892804698972,23.689672050905546
1522800000,7424.91,7424.91,6708.46,6791.68,14839,17330.84999999998,14839,17330.84999999998,34.61830221026713,1021729.0268599992,2228406.1971873203,2228406.1971873203,1021729.0268599992,36.32176582335765,0,78.57142857142857,-56.780629621733056,-647.8016804757217,-591.0210508539886,34.61830221026713,13.021688840784634,23.551404846096116
1522886400,6791.68,6933.11,6568.64,6785.85,14188,17219.64999999998,14188,17219.64999999998,34.571890969360936,1007541.0268599992,2231129.193867431,2231129.193867431,1007541.0268599992,36.934607056723785,0,71.42857142857143,-48.86757215511818,-652.1055160478863,-603.2379438927682,34.571890969360936,13.175755198116923,20.662241502932932
1522972800,6785.86,6847,6518.88,6619.01,10557,17090.84999999998,10557,17090.84999999998,33.20014496066089,996984.0268599992,2227015.4000724778,2227015.4000724778,996984.0268599992,37.556923234000635,7.142857142857143,64.28571428571429,-46.493835999088446,-661.3552388916287,-614.8614028925402,33.20014496066089,6.630443311102401,10.942629116668
1523059200,6619.01,7064.64,6605.08,6894.01,10191,16109.34999999998,10191,16109.34999999998,37.59540274025905,1007175.0268599992,2229638.768729454,2229638.768729454,1007175.0268599992,37.51150168325042,0,57.142857142857146,-19.413308859584617,-639.128038967021,-619.7147301074364,37.59540274025905,20.00045045045046,13.26888298655661
1523145600,6894.01,7099.99,6880,7020.01,6198.71155,15195.13557749998,6198.71155,15195.13557749998,39.55773304409521,1013373.7384099992,2231330.248589204,2231330.248589204,1013373.7384099992,37.36789508568211,0,50,12.26876518614506,-604.378773624755,-616.6475388109001,39.55773304409521,27.83251953125001,18.15447109760097
1523232000,7020.01,7169.53,6617,6771.13,13781.81272,14892.326213499979,13781.81272,14892.326213499979,37.07761981331672,999591.9256899991,2225237.3968108133,2225237.3968108133,999591.9256899991,37.58799891391599,0,42.857142857142854,21.222244202755178,-590.1197335574561,-611.3419777602113,37.07761981331672,18.143040356160213,21.992003445953575
1523318400,6771.14,6893.29,6661.19,6824.99,7345.37333,14493.294879999978,7345.37333,14493.294879999978,37.98378300853081,1006937.2990199991,2228259.7283619335,2228259.7283619335,1006937.2990199991,37.792381040133165,0,35.714285714285715,34.73231377300044,-567.9265855439608,-602.6588993169612,37.98378300853081,22.89316239316238,22.95624076019088
1523404800,6825,6974,6806.01,6942.99,8105.49359,14172.869559499979,8105.49359,14172.869559499979,40.021742114763995,1015042.7926099991,2233372.765779234,2233372.765779234,1015042.7926099991,37.715515618578,0,28.571428571428573,54.4042488437841,-534.6535882622311,-589.0578371060152,40.021742114763995,32.71333775713336,24.583180168818668
1523491200,6943,8050,6767.77,7916,30761.46984,14958.793051499979,30761.46984,14958.793051499979,53.57061348222851,1045804.2624499991,2257704.7542335857,2257704.7542335857,1045804.2624499991,35.09623260464165,100,21.428571428571427,131.34782894516877,-424.87305092455426,-556.220879869723,53.57061348222851,91.625,49.07716671676527
1523577600,7915.99,8220,7760,7893.19,21595.42976,15483.414539499976,21595.42976,15483.414539499976,53.26683373265403,1024208.8326899991,2248614.956168083,2248614.956168083,1024208.8326899991,32.98130217872549,100,14.285714285714286,176.3043827494331,-335.8404014329317,-512.1447841823648,53.26683373265403,81.53615819209038,68.6248319830746
1523664000,7893.19,8150,7830,8003.11,9206.80991,15500.155034999978,9206.80991,15500.155034999978,54.60280565535956,1033415.6425999991,2249369.3391550835,2249369.3391550835,1033415.6425999991,31.01743821180335,92.85714285714286,7.142857142857143,206.92407649226016,-253.4896885670396,-460.41376505929975,54.60280565535956,87.7463276836158,86.96916195856875
1523750400,8003.12,8392.56,8003.11,8355.25,9769.19072,15038.564570999977,9769.19072,15038.564570999977,58.67824305839448,1043184.833319999,2257266.7183164074,2257266.7183164074,1043184.833319999,29.660612381712014,100,0,241.9388618602203,-157.9901877340244,-399.9290495942447,58.67824305839448,98.0087314802955,89.09707245200057
1523836800,8355.24,8398.98,7905.99,8048.93,13212.12234,14962.270687999979,13212.12234,14962.270687999979,54.12628636652289,1029972.710979999,2251716.1743746693,2251716.1743746693,1029972.710979999,28.169057312164732,100,28.571428571428573,235.3000660808034,-105.80396699324046,-341.10403307404385,54.12628636652289,81.38130950481361,89.04545622290833
1523923200,8048.92,8162.5,7822,7892.1,10445.47419,14945.044397499976,10445.47419,14945.044397499976,51.90615657464661,1019527.2367899991,2245571.5973401405,2245571.5973401405,1019527.2367899991,26.5800492879317,92.85714285714286,21.428571428571427,211.9054353642179,-76.22223886877146,-288.12767423298936,51.90615657464661,73.03973192915274,84.14325763808729
1524009600,7892.11,8243.99,7879.8,8152.05,10634.79001,14117.283897999976,10634.79001,14117.283897999976,55.18723941003586,1030162.0267999991,2250836.8681787224,2250836.8681787224,1030162.0267999991,25.283958172669625,85.71428571428571,14.285714285714286,205.34990769810696,-31.44028961035565,-236.7901973084626,55.18723941003586,86.86612414233288,80.42905519209977
1524096000,8152.05,8300,8101.47,8274,11781.3653,13261.652162999977,11781.3653,13261.652162999977,56.68034115741304,1041943.392099999,2259532.3976070657,2259532.3976070657,1041943.392099999,24.207197204786233,78.57142857142857,7.142857142857143,200.4175836046524,13.731782197352913,-186.6858014072995,56.68034115741304,93.35248125099731,84.41944577416099
1524182400,8274,8932.57,8216.21,8866.27,15988.43534,13324.573929999979,15988.43534,13324.573929999979,63.10913069381601,1057931.827439999,2272561.334194924,2272561.334194924,1057931.827439999,24.430743379130057,100,0,226.31914407649816,96.2131286883232,-130.10601538817497,63.10913069381601,97.15143781498527,92.4566810694385
1524268800,8866.27,9038.87,8610.7,8915.42,12056.53869,13170.200864499979,12056.53869,13170.200864499979,63.59199986095944,1069988.366129999,2277665.588973018,2277665.588973018,1069988.366129999,24.811510946188058,100,0,235.01250676037495,163.6596180622937,-71.35288869808123,63.59199986095944,94.90269915395952,95.1355394066474
1524355200,8915.42,9015,8754.01,8795.01,7688.93372,12850.747550499978,7688.93372,12850.747550499978,61.4692811983978,1062299.432409999,2272392.4281371897,2272392.4281371897,1062299.432409999,25.16508082988477,92.85714285714286,7.142857142857143,221.10781989398168,205.03188616939588,-16.075933724585802,61.4692811983978,89.93092114770816,93.99501937221767
1524441600,8795,8991,8775.1,8931.3,7899.07655,12312.301377999978,7899.07655,12312.301377999978,62.97575733762284,1070198.508959999,2275923.0482718586,2275923.0482718586,1070198.508959999,25.493395721888856,85.71428571428571,0,209.64606488333405,245.98164737958177,36.33558249624772,62.97575733762284,95.47584199724095,93.43648743296957
1524528000,8931.31,9728.56,8930,9645.1,20479.80028,12594.341391999978,20479.80028,12594.341391999978,69.66524520752645,1090678.3092399992,2292122.0327550024,2292122.0327550024,1090678.3092399992,26.923614362004006,100,0,236.69384961215658,332.20289451144345,95.50904489928686,69.66524520752645,97.18115773155141,94.19597362550019
1524614400,9645,9763.49,8602.43,8865.98,31235.7563,13446.729206999978,31235.7563,13446.729206999978,57.46143031673035,1059442.5529399992,2275066.738399889,2275066.738399889,1059442.5529399992,27.244606429976553,100,7.142857142857143,190.6466383979103,333.81734289667475,143.17070449876445,57.46143031673035,70.04025743393908,87.56575238757716
1524700800,8865.98,9318,8660,9272.12,14938.987,13665.82855699998,14938.987,13665.82855699998,61.27016869350215,1074381.539939999,2287922.4405258466,2287922.4405258466,1074381.539939999,27.542670493093922,92.85714285714286,0,176.4047726769632,363.67667034496844,187.27189766800524,61.27016869350215,75.47429735112235,80.89857083887097
1524787200,9272.12,9369,8910,8922.55,11855.66276,13749.061694999978,11855.66276,13749.061694999978,56.574853312867425,1062525.8771799991,2276715.093964705,2276715.093964705,1062525.8771799991,27.903673571834446,85.71428571428571,0,134.21475459034778,355.04034090593996,220.82558631559218,56.574853312867425,56.685844377256615,67.40013305410604
1524873600,8922.56,9447,8863.42,9329.99,8707.58195,13874.50521499998,8707.58195,13874.50521499998,60.38538297374646,1071233.4591299992,2281930.86960205,2281930.86960205,1071233.4591299992,28.37148109167917,78.57142857142857,21.428571428571427,124.72375362246214,376.73027834366985,252.0065247212077,60.38538297374646,77.67178816269977,69.9439766303596
1524960000,9329.99,9512.5,9179.99,9389.01,7717.3954,13571.28434899998,7717.3954,13571.28434899998,60.92033533180786,1078950.8545299992,2283915.979308712,2283915.979308712,1078950.8545299992,28.919644785663596,71.42857142857143,14.285714285714286,113.70577596236114,394.13874467415917,280.432968711798,60.92033533180786,80.71172140984504,71.68978464993383
1525046400,9389.01,9447,9110.88,9243.83,8757.37497,13641.88443099998,8757.37497,13641.88443099998,58.81631596431883,1070193.4795599992,2282086.4455993418,2282086.4455993418,1070193.4795599992,29.16754666715829,64.28571428571429,7.142857142857143,89.01757407402101,391.7049363043243,302.6873622303033,58.81631596431883,73.23395948472566,77.20582301909018
1525132800,9243.83,9245.37,8831.21,9072.29,11247.0567,13798.96258649998,11247.0567,13798.96258649998,56.340319334409074,1058946.4228599991,2283933.0745726856,2283933.0745726856,1058946.4228599991,28.406479980920896,57.142857142857146,0,55.170214138026836,371.65012990283685,316.47991576481,56.340319334409074,63.306064161300476,72.41724835195707
1525219200,9072.29,9251.05,8990,9190.48,8656.20958,12693.69957349998,8656.20958,12693.69957349998,57.66275583113607,1067602.6324399991,2288572.378469785,2288572.378469785,1067602.6324399991,27.71308939961098,50,0,35.72055357818198,361.1306077375375,325.4100541593555,57.66275583113607,65.52327890157757,67.35443418253459
1525305600,9190.47,9800,9131,9725.74,14569.70555,12342.413362999981,14569.70555,12342.413362999981,63.11212958380682,1082172.3379899992,2299907.5658310167,2299907.5658310167,1082172.3379899992,28.185938526120495,100,0,52.84969408440713,391.47217176486447,338.62247768045734,63.11212958380682,95.31124707189714,74.71353004492508
1525392000,9725.74,9745,9451.5,9685,10684.15345,12416.280539999982,10684.15345,12416.280539999982,62.45322909958403,1071488.184539999,2306223.411226502,2306223.411226502,1071488.184539999,28.625012715022187,92.85714285714286,0,55.12835109762392,407.5329165524872,352.4045654548633,62.45322909958403,90.39722103927119,83.74391567091531
1525478400,9685,9948.12,9660.28,9800,9219.29564,12388.78578599998,9219.29564,12388.78578599998,63.6082025409738,1080707.480179999,2305954.365633895,2305954.365633895,1080707.480179999,29.390281796557087,100,28.571428571428573,57.79287609265543,424.6456605706826,366.85278447802716,63.6082025409738,88.99300730480269,91.56715847199035
1525564800,9799.99,9880,9390,9600,7493.54267,12102.85680249998,7493.54267,12102.85680249998,60.143205900237206,1073213.937509999,2304883.8595381808,2304883.8595381808,1073213.937509999,29.120740761523546,92.85714285714286,21.428571428571427,40.32529110254853,417.25939835621284,376.9341072536643,60.143205900237206,74.13074333613234,84.50699056006876
1525651200,9600,9619.55,9162.85,9356.25,9671.35727,12064.15095649998,9671.35727,12064.15095649998,56.13006375952633,1063542.5802399989,2303403.61457831,2303403.61457831,1063542.5802399989,28.136158162417836,85.71428571428571,14.285714285714286,8.271036979124005,387.27290347756934,379.00186649844534,56.13006375952633,56.01735912431536,73.04703658841682
1525737600,9356.25,9463.13,9050,9177.81,9461.10482,12005.46669699998,9461.10482,12005.46669699998,53.324887287178136,1054081.4754199989,2299796.4724675985,2299796.4724675985,1054081.4754199989,26.87631983104667,78.57142857142857,7.142857142857143,-27.096441540433375,345.13131457290365,372.227756113337,53.324887287178136,42.75724721146765,57.63511655730513
1525824000,9177.81,9370,8960,9300.08,8483.50472,11840.573667999979,8483.50472,11840.573667999979,54.98498787975211,1062564.980139999,2305386.481333831,2305386.481333831,1062564.980139999,25.431999491562678,71.42857142857143,0,-43.434195299753014,317.9350119886458,361.3692072883988,54.98498787975211,49.6910225755364,49.48854297043982
1525910400,9300.08,9386.32,9001.01,9010.51,7424.17283,11412.36054249998,7424.17283,11412.36054249998,50.41198799270834,1055140.807309999,2298328.401477722,2298328.401477722,1055140.807309999,24.135817671290553,64.28571428571429,0,-73.17170554721099,269.9045753543851,343.0762809015961,50.41198799270834,16.053218253932798,36.167162680312295
1525996800,9010.51,9010.51,8351,8403.33,17329.42249,11676.00473249998,17329.42249,11676.00473249998,42.44132316337177,1037811.3848199989,2283749.047004588,2283749.047004588,1037811.3848199989,23.61104333341302,57.142857142857146,100,-129.85138922600606,180.76204436908847,310.61343359509453,42.44132316337177,3.2765227409336743,23.006921190134303
1526083200,8403.33,8658.57,8223.43,8475,11103.57878,11846.736985499982,11103.57878,11846.736985499982,43.5753778880269,1048914.963599999,2285484.220413238,2285484.220413238,1048914.963599999,23.392879910919245,50,100,-156.8280839128455,114.57832870403763,271.40641261688313,43.5753778880269,14.586389438101898,11.305376810989467
1526169600,8474.31,8774.32,8345,8686.1,6329.83863,11768.27508949998,6329.83863,11768.27508949998,46.89432013851867,1055244.8022299989,2289212.650471829,2289212.650471829,1055244.8022299989,22.8254424521893,42.857142857142854,92.85714285714286,-154.5178178372981,78.25914032026049,232.7769581575586,46.89432013851867,26.826270228272904,14.896394135769505
1526256000,8686.1,8880.01,8289.79,8670,13869.88142,11437.779146499981,13869.88142,11437.779146499981,46.66885442765759,1041374.9208099989,2293212.2672548657,2293212.2672548657,1041374.9208099989,21.968705872110085,35.714285714285715,85.71428571428571,-148.11935596059564,47.62776320681405,195.7471191674097,46.66885442765759,25.892769135322844,22.43514293389923
1526342400,8670,8847,8420.45,8477.46,10686.52101,10410.317381999981,10686.52101,10410.317381999981,43.94756431122467,1030688.3997999988,2285382.3331058673,2285382.3331058673,1030688.3997999988,21.17316476203653,28.571428571428573,78.57142857142857,-150.41630473206553,7.7267382523277774,158.1430429843933,43.94756431122467,14.729023766589867,22.482687710061885
1526428800,8477.47,8500,8103.33,8344.01,10586.6902,10192.70254199998,10586.6902,10192.70254199998,42.114564937905755,1020101.7095999989,2287642.616951477,2287642.616951477,1020101.7095999989,21.212627842434976,21.428571428571427,100,-153.92914365002378,-34.268386578136415,119.66075707188736,42.114564937905755,13.046471414090503,17.88942143866775
1526515200,8344.01,8483.48,8001,8059,8366.62975,10018.250891499982,8366.62975,10018.250891499982,38.42815798113423,1011735.0798499989,2281287.5297545358,2281287.5297545358,1011735.0798499989,21.476987151096434,14.285714285714286,100,-167.3412996084876,-89.51586743872213,77.82543216976546,38.42815798113423,2.97875837133818,10.251417850672864
1526601600,8059,8280,7927.21,8238.51,8160.25096,9990.884341999981,8160.25096,9990.884341999981,41.87894142829978,1019895.3308099989,2287528.401977438,2287528.401977438,1019895.3308099989,21.88689666073645,7.142857142857143,100,-156.22908246036496,-117.46092090569073,38.76816155467422,41.87894142829978,15.403951685131949,10.476393823520224
1526688000,8238.51,8390,8152.54,8235.6,4179.92594,9814.01086899998,4179.92594,9814.01086899998,41.83800635553237,1015715.4048699989,2286272.62872485,2286272.62872485,1015715.4048699989,21.841259243326494,0,92.85714285714286,-141.61352470286423,-138.24874432390607,3.3647803789581587,41.83800635553237,15.792276691298108,11.391662249256091
1526774400,8235.6,8600,8172,8516.86,4428.51598,9597.56791949998,4428.51598,9597.56791949998,47.20905374979583,1020143.920849999,2288980.64555262,2288980.64555262,1020143.920849999,21.03708256855633,0,85.71428571428571,-107.11048121576971,-130.52332114075398,-23.41283992498427,47.20905374979583,34.84228937447563,22.01283925030191
1526860800,8516.86,8584.39,8309.23,8393.44,5091.12581,9289.77137499998,5091.12581,9289.77137499998,45.23501056537062,1015052.795039999,2287005.697271767,2287005.697271767,1015052.795039999,20.29034708484118,0,78.57142857142857,-87.53265925197748,-132.8286639899561,-45.296004737978635,45.23501056537062,30.35509661961565,26.99655422846314
1526947200,8393.43,8400,7950,7987.7,6882.80163,9201.10097749998,6882.80163,9201.10097749998,39.401955270891555,1008169.993409999,2281276.1472926605,2281276.1472926605,1008169.993409999,20.545922255317155,0,71.42857142857143,-96.15347698009114,-165.48785096309257,-69.33437398300143,39.401955270891555,4.1456778447135445,23.114354612934957
1527033600,7987.7,8030.06,7433.19,7505,15871.71519,9266.20145949998,15871.71519,9266.20145949998,33.81533394074475,992298.2782199989,2269223.5145420325,2269223.5145420325,992298.2782199989,21.80081376603277,7.142857142857143,100,-126.68899244164652,-227.69561453505958,-101.00662209341306,33.81533394074475,3.6766625877437957,12.725812350691013
1527120000,7505.01,7734.99,7269,7584.15,11373.69018,9300.67829599998,11373.69018,9300.67829599998,35.43195198712415,1003671.968399999,2273233.924708508,2273233.924708508,1003671.968399999,23.232044396204508,0,100,-133.21478944995698,-267.52510890585927,-134.3103194559023,35.43195198712415,18.09636464906889,8.639568360508758
1527206400,7584.15,7661.85,7326.94,7459.11,8681.27177,9273.777102499978,8681.27177,9273.777102499978,34.01829103514301,994990.696629999,2271404.6650602175,2271404.6650602175,994990.696629999,24.561044267078262,0,92.85714285714286,-137.0769723379623,-305.65653487835516,-168.57956254039286,34.01829103514301,11.800671628357344,11.191232955056691
1527292800,7459.11,7640.46,7287.23,7337.95,4572.30621,9127.71527949998,4572.30621,9127.71527949998,32.65859249836309,990418.390419999,2268145.426092361,2268145.426092361,990418.390419999,25.864066965868865,14.285714285714286,85.71428571428571,-138.50715280580673,-341.71350354765127,-203.20635074184455,32.65859249836309,4.2799237745265275,11.392320017317601
1527379200,7337.94,7392.7,7229.01,7346.64,4565.97531,8872.44618149998,4565.97531,8872.44618149998,32.86585407678291,994984.365729999,2270141.8024924877,2270141.8024924877,994984.365729999,27.178343744727734,7.142857142857143,100,-129.735619383941,-365.3758749717708,-235.6402555878298,32.86585407678291,7.1247728649303514,7.735122755938089
1527465600,7346.64,7444.8,7087,7107.94,7785.67997,8788.674938999979,7785.67997,8788.674938999979,30.123292561130057,987198.685759999,2263267.425700642,2263267.425700642,987198.685759999,28.649007315601015,0,100,-130.52182574475052,-398.79253776876794,-268.2707120240174,30.123292561130057,1.1897727272727046,4.198156455576542
1527552000,7107.94,7524.99,7058,7460,10349.07902,8881.953653999979,10349.07902,8881.953653999979,38.30111571353217,997547.7647799989,2270735.9863133538,2270735.9863133538,997547.7647799989,29.625995218683038,0,100,-99.25901528092658,-392.34448112517566,-293.0854658442491,38.30111571353217,26.070038910505836,11.461528167569645
1527638400,7460,7557.78,7272.71,7380.01,6250.21839,8823.25593199998,6250.21839,8823.25593199998,37.23486637031548,991297.5463899989,2269190.9170674025,2269190.9170674025,991297.5463899989,30.370993882021697,28.571428571428573,92.85714285714286,-76.89354042647642,-389.2023913773446,-312.3088509508682,37.23486637031548,20.882619974059676,16.047477203946087
1527724800,7380,7609.99,7340,7485,5971.99838,8255.38472649998,5971.99838,8255.38472649998,39.61116451385302,997269.5447699989,2269633.5248957807,2269633.5248957807,997269.5447699989,30.796367349125138,21.428571428571427,85.71428571428571,-49.29693092542567,-373.93001460765026,-324.6330836822246,39.61116451385302,27.691309987029832,24.881322957198464
1527811200,7485,7599.99,7351.01,7514.32,6814.1107,8040.911322499979,6814.1107,8040.911322499979,40.291029643380206,1004083.6554699988,2271758.38454213,2271758.38454213,1004083.6554699988,31.19135699714976,14.285714285714286,78.57142857142857,-24.584932386843718,-355.36424916577926,-330.77931677893554,40.291029643380206,29.592736705577153,26.05555555555557
1527897600,7514.32,7697.09,7440,7636.42,5002.4796,7974.543370999978,5002.4796,7974.543370999978,43.16082078667184,1009086.1350699988,2274399.819859334,2274399.819859334,1009086.1350699988,31.029189776047854,7.142857142857143,71.42857142857143,3.000640969562369,-327.0285155669826,-330.029156536545,43.16082078667184,37.51102464332037,31.598357111975798
1527984000,7636.41,7777,7583.24,7706.37,5122.07745,7537.153172499979,5122.07745,7537.153172499979,44.79772923454311,1014208.2125199988,2275787.665989211,2275787.665989211,1014208.2125199988,30.45564533391311,0,64.28571428571429,27.60630377721526,-295.5212768150259,-323.12758059224115,44.79772923454311,42.47734851512393,36.5270366213405
1528070400,7706.37,7747.57,7447.61,7487.37,5958.59047,7300.756645499979,5958.59047,7300.756645499979,40.83287162645843,1008249.6220499987,2271408.7098510363,2271408.7098510363,1008249.6220499987,30.349056629431136,0,57.142857142857146,30.551312569460947,-284.938439880415,-315.48975244987594,40.83287162645843,31.994783904619958,37.32771902102143
1528156800,7487.37,7677.5,7355,7612.51,5691.18443,7055.981356999978,5691.18443,7055.981356999978,43.88889809257253,1013940.8064799987,2274806.1263672025,2274806.1263672025,1013940.8064799987,30.52349342991606,0,50,41.65803903913502,-263.41720365095716,-305.0752426900922,43.88889809257253,57.044832623500604,43.83898834774818
1528243200,7612.51,7691,7484,7655,5656.2435,6920.462044499979,5656.2435,6920.462044499979,44.928997538998914,1019597.0499799987,2278494.980823724,2278494.980823724,1019597.0499799987,30.60590822839143,0,42.857142857142854,51.92866206368382,-240.16441511048743,-292.09307717417124,44.928997538998914,83.03198887343532,57.357201800518645
1528329600,7655,7747,7635,7684.93,4944.0538,6759.652186499979,4944.0538,6759.652186499979,45.69263888961882,1024541.1037799987,2277959.080706474,2277959.080706474,1024541.1037799987,30.342723936030918,71.42857142857143,35.714285714285715,60.21692283401484,-216.82192363165268,-277.0388464656675,45.69263888961882,87.19471488178029,75.75717879290542
1528416000,7684.93,7690,7536.58,7618.8,3913.53153,6746.332465999978,3913.53153,6746.332465999978,44.23318246993051,1020627.5722499987,2278240.185630608,2278240.185630608,1020627.5722499987,30.432343559238973,64.28571428571429,28.571428571428573,60.560621688764854,-201.33806935471148,-261.89869104347633,44.23318246993051,77.99721835883173,82.74130737134912
1528502400,7616,7680,7468,7496.4,2653.91071,6657.602202499978,2653.91071,6657.602202499978,41.5855659320067,1017973.6615399987,2276297.32269574,2276297.32269574,1017973.6615399987,30.73941623052443,57.142857142857146,21.428571428571427,52.17775593466385,-196.6764961251465,-248.85425205981036,41.5855659320067,60.9735744089012,75.38850254983775
1528588800,7496.41,7496.41,6652,6770.31,18582.26384,7332.1591039999785,18582.26384,7332.1591039999785,30.082482072357195,999391.3976999987,2262922.168281044,2262922.168281044,999391.3976999987,32.74910501849175,50,100,0.11968308990986998,-248.704648197423,-248.82433128733288,30.082482072357195,10.51644444444448,49.82907907072581
1528675200,6770.31,6913.83,6666.66,6881,11400.72474,7558.055259499978,11400.72474,7558.055259499978,33.11967687320876,1010792.1224399987,2271294.3232656997,2271294.3232656997,1010792.1224399987,34.615244607318544,42.857142857142854,92.85714285714286,-23.183121282114683,-277.80323288997624,-254.62011160786156,33.11967687320876,20.355555555555554,30.615191469633753
1528761600,6881,6885.84,6450,6544.99,10666.05709,7297.772354499978,10666.05709,7297.772354499978,29.001245832220718,1000126.0653499987,2265277.535462498,2265277.535462498,1000126.0653499987,36.64847805357093,35.714285714285715,100,-55.695620350802585,-324.2396370463648,-268.5440166955622,29.001245832220718,7.158251695553864,12.67675056518464
1528848000,6549.47,6618.95,6135,6302.32,17230.75645,7590.625667999979,17230.75645,7590.625667999979,26.443737185812225,982895.3088999987,2259961.4403172364,2259961.4403172364,982895.3088999987,38.90043893224357,28.571428571428573,100,-86.1925363827985,-376.2846871740603,-290.0921507912618,26.443737185812225,10.190012180267948,12.567939810459135
1528934400,6302.32,6750,6269,6638.49,14293.88839,7871.256498999979,14293.88839,7871.256498999979,34.995774577439946,997189.1972899986,2267627.83808616,2267627.83808616,997189.1972899986,40.29200315723345,21.428571428571427,92.85714285714286,-76.69075853397726,-385.9555989587334,-309.26484042475613,34.995774577439946,30.663215590742983,16.003826488854944
1529020800,6638.49,6660,6370,6391.22,6963.60358,7990.821367499979,6963.60358,7990.821367499979,32.044556151077586,990225.5937099986,2261683.321871454,2261683.321871454,990225.5937099986,41.5841699375812,14.285714285714286,85.71428571428571,-79.67565718604271,-408.85941190730955,-329.18375472126684,32.044556151077586,15.60414129110842,18.81912302070646
1529107200,6385.7,6549.99,6330,6484.29,4467.8979,7985.9174969999785,4467.8979,7985.9174969999785,34.29068992991094,994693.4916099986,2263482.5449041417,2263482.5449041417,994693.4916099986,42.84408154942779,7.142857142857143,78.57142857142857,-68.42918879892852,-414.72024071992746,-346.29105192099894,34.29068992991094,21.27222898903776,22.513195290296398
1529193600,6484.3,6570.01,6428.14,6447.16,3213.98743,7757.332869999979,3213.98743,7757.332869999979,33.81055469257234,991479.5041799987,2261130.3329153005,2261130.3329153005,991479.5041799987,43.89151735991997,0,71.42857142857143,-57.00542958179875,-417.5478388982474,-360.54240931644864,33.81055469257234,19.357919346136907,18.74476320876104
1529280000,6447.15,6807.64,6385,6709.02,7889.98958,7634.378397999979,7889.98958,7634.378397999979,40.172859882111226,999369.4937599987,2265338.1780112023,2265338.1780112023,999369.4937599987,43.50275918323669,0,64.28571428571429,-26.858630032265296,-394.11569685678023,-367.25706682451494,40.172859882111226,35.60918114143923,25.413109825537976
1529366400,6709.19,6829.06,6670.01,6736.41,6073.82849,7625.55890299998,6073.82849,7625.55890299998,40.81370701823974,1005443.3222499987,2264335.7385402024,2264335.7385402024,1005443.3222499987,43.02695513004521,14.285714285714286,57.142857142857146,-1.4590479601017137,-369.0808767746421,-367.6218288145404,40.81370701823974,37.30831265508684,30.758471047554337
1529452800,6736.41,6817,6557.66,6756.1,6608.74446,7657.396206999979,6608.74446,7657.396206999979,41.30048295382875,1012052.0667099986,2267840.6614715992,2267840.6614715992,1012052.0667099986,42.86278246941848,7.142857142857143,50,19.14551155713002,-343.68993936812785,-362.8354509252579,41.30048295382875,38.529776674937985,37.149090157154696
1529539200,6759.54,6787,6682.3,6719.01,4333.61004,7533.37117399998,4333.61004,7533.37117399998,40.62272777683703,1007718.4566699986,2266545.9592552553,2266545.9592552553,1007718.4566699986,42.71033642740794,0,42.857142857142854,31.997315329496814,-322.83880676338686,-354.83612209288367,40.62272777683703,37.556913183279754,37.798334171101544
1529625600,6719.01,6725,5921.21,6059.82,17886.30851,8177.56261949998,17886.30851,8177.56261949998,30.913165478863633,989832.1481599986,2254828.4789779307,2254828.4789779307,989832.1481599986,43.94866067451355,0,100,-0.4577678085224761,-355.40833185353677,-354.9505640450143,30.913165478863633,7.880986359940622,27.989225406052807
1529712000,6059.82,6250,6040.01,6178.29,5970.78367,8219.99793049998,5970.78367,8219.99793049998,33.967864153447366,995802.9318299986,2256721.307536014,2256721.307536014,995802.9318299986,45.09853318968303,0,92.85714285714286,-9.979493044258561,-367.4249303503375,-357.44543730607893,33.967864153447366,16.32046724225495,20.58612226182513
1529798400,6178.29,6255.8,5777,6149.99,12954.57564,8569.797188999979,12954.57564,8569.797188999979,33.58583895165674,982848.3561899986,2263950.220483999,2263950.220483999,982848.3561899986,46.4959829719533,0,100,-13.971662504281994,-374.9100154364314,-360.9383529321494,33.58583895165674,32.80965491762179,19.00370283993914
1529884800,6150,6340.01,6070.13,6246,9100.58234,8740.26708449998,9100.58234,8740.26708449998,36.20710326304255,991948.9385299985,2266710.6090654144,2266710.6090654144,991948.9385299985,47.34301707193685,0,92.85714285714286,-6.323719375346286,-368.84300215133226,-362.51928277598597,36.20710326304255,42.29645395187763,30.47552537058481
1529971200,6246.01,6271,6006.39,6074.95,6599.71676,8787.440747499979,6599.71676,8787.440747499979,33.658314848068656,985349.2217699985,2263530.843033396,2263530.843033396,985349.2217699985,48.21963116479884,0,85.71428571428571,-8.80962926208349,-373.53131935359033,-364.72169009150684,33.658314848068656,28.320628101058848,34.475578990186115
1530057600,6074.01,6175.43,5983.56,6132.17,6921.91194,8886.33365449998,6921.91194,8886.33365449998,35.299129722827644,992271.1337099986,2267331.4550252603,2267331.4550252603,992271.1337099986,49.066935778055814,42.857142857142854,78.57142857142857,-2.9291893429002585,-368.3831767701322,-365.45398742723194,35.299129722827644,33.75948139839932,34.79218781711196
1530144000,6132.16,6161.47,5816.6,5851.66,7699.29173,9075.621664499979,7699.29173,9075.621664499979,31.22229515618966,984571.8419799985,2261197.6063204804,2261197.6063204804,984571.8419799985,50.09138582561259,35.714285714285715,71.42857142857143,-13.659609212140936,-382.5284989424081,-368.86888973026714,31.22229515618966,7.096553428511665,23.058887642656632
1530230400,5850.25,6299.99,5790.01,6202.36,10815.15161,9483.68370949998,10815.15161,9483.68370949998,40.47798543010025,995386.9935899985,2267871.8769089333,2267871.8769089333,995386.9935899985,50.23363160058088,28.571428571428573,64.28571428571429,6.074592740587036,-361.2756488045334,-367.3502415451204,40.47798543010025,40.43115411668532,27.095729647865454
1530316800,6202.36,6520.15,6185,6383.19,6669.80006,8888.06052049998,6669.80006,8888.06052049998,44.61664580076275,1002056.7936499985,2269090.4114686046,2269090.4114686046,1002056.7936499985,49.21362115586739,21.428571428571427,57.142857142857146,33.014378199612224,-326.08226879560516,-359.0966469952174,44.61664580076275,57.61933730015392,35.04901494845032
1530403200,6383.19,6424.14,6256.76,6349.5,4005.66918,8518.30774249998,4005.66918,8518.30774249998,44.00277434729787,998051.1244699985,2269523.5732093025,2269523.5732093025,998051.1244699985,48.26646860006201,14.285714285714286,50,49.292844047182825,-297.48059193623885,-346.7734359834217,44.00277434729787,54.4170484573123,50.82251329138387
1530489600,6349.5,6669.99,6270.01,6611.79,8176.60616,8393.83519599998,8176.60616,8393.83519599998,49.79437135805605,1006227.7306299985,2275320.668001174,2275320.668001174,1006227.7306299985,46.214221759063314,7.142857142857143,42.857142857142854,76.81206100200978,-250.75835973090943,-327.5704207329192,49.79437135805605,79.34813603786853,63.79484059844494
1530576000,6611.79,6673.99,6465,6502.62,6322.84786,7848.439766499981,6322.84786,7848.439766499981,47.588209120737154,999904.8827699985,2271274.1542862835,2271274.1542862835,999904.8827699985,44.290535213652895,0,35.714285714285715,86.05338052899037,-220.00369507168125,-306.0570756006716,47.588209120737154,69.77115384615384,67.84544611377824
1530662400,6502.62,6796.62,6411.51,6587.47,6731.65746,7470.328219999979,6731.65746,7470.328219999979,49.46236340709323,1006636.5402299985,2270693.998717492,2270693.998717492,1006636.5402299985,41.94898807407204,0,28.571428571428573,95.5397928826211,-186.63233449739528,-282.1721273800164,49.46236340709323,79.48745611110026,76.2022486650409
1530748800,6587.46,6700,6449.5,6532.95,6885.24798,7466.410439999981,6885.24798,7466.410439999981,48.26803263374857,999751.2922499985,2268396.1674555037,2268396.1674555037,999751.2922499985,39.7746943016041,92.85714285714286,21.428571428571427,95.57050894066896,-162.70899120418017,-258.2795001448491,48.26803263374857,74.14036601871285,74.46632532532233
1530835200,6532.96,6639,6452.2,6600,5214.13763,7503.72242649998,5214.13763,7503.72242649998,49.871149284145865,1004965.4298799986,2271433.095582613,2271433.095582613,1004965.4298799986,37.7557072271696,85.71428571428571,14.285714285714286,97.21345642991633,-136.76267960745372,-233.97613603737005,49.871149284145865,80.71634530511368,78.11472247830893
1530921600,6599.99,6843.26,6512,6753.28,4495.77736,7567.811922999981,4495.77736,7567.811922999981,53.42447699806492,1009461.2072399985,2273486.501108689,2273486.501108689,1009461.2072399985,35.18775739866785,100,7.142857142857143,105.06222134343011,-102.64835935808242,-207.71058070151253,53.42447699806492,91.56115769136979,82.13928967173212
1531008000,6753.29,6778.31,6671,6701.97,3321.49949,7339.38741849998,3321.49949,7339.38741849998,52.093315580718574,1006139.7077499985,2272082.191800504,2272082.191800504,1006139.7077499985,32.80323255791622,92.85714285714286,0,103.09331327077689,-78.84393911304142,-181.9372523838183,52.093315580718574,86.5853311179682,86.28761137148389
1531094400,6701.97,6815.82,6625,6664.01,5254.14026,7298.403006999981,5254.14026,7298.403006999981,51.079300862066304,1000885.5674899985,2268976.296080307,2268976.296080307,1000885.5674899985,30.55115669205808,85.71428571428571,28.571428571428573,95.69108668235057,-62.32339403088008,-158.01448071323065,51.079300862066304,82.98124851649656,87.04257910861152
1531180800,6664.01,6679.47,6279,6303.7,8177.86823,7376.859195499981,8177.86823,7376.859195499981,42.602497416589074,992707.6992599985,2261807.2092585573,2261807.2092585573,992707.6992599985,29.8474524120575,78.57142857142857,21.428571428571427,64.48167498398368,-77.41238698325105,-141.89406196723473,42.602497416589074,48.77189651079986,72.77949204842156
1531267200,6303.69,6400,6281.01,6390.04,5038.31529,7412.0944579999805,5038.31529,7412.0944579999805,44.959655577067494,997746.0145499986,2266002.0650933357,2266002.0650933357,997746.0145499986,29.194012723485535,71.42857142857143,14.285714285714286,48.343622576431414,-81.46453374669545,-129.80815632312687,44.959655577067494,56.969380488962706,62.90750850541972
1531353600,6390.04,6390.04,6075.01,6249.75,9411.46342,6988.35220349998,9411.46342,6988.35220349998,41.94540421590255,988334.5511299985,2267031.2525193556,2267031.2525193556,988334.5511299985,29.264760112858696,64.28571428571429,7.142857142857143,27.92480751992457,-94.90214692322115,-122.82695444314572,41.94540421590255,43.6496558272015,49.79697760898804
1531440000,6246.68,6335.09,6121.53,6216.29,5975.49074,6988.58755699998,5975.49074,6988.58755699998,41.23532015262708,982359.0603899985,2266358.6040955423,2266358.6040955423,982359.0603899985,29.330454117276627,57.142857142857146,0,12.647276133656675,-107.01785927607489,-119.66513540973156,41.23532015262708,18.389847054995087,39.669627790386436
1531526400,6216.29,6323.68,6187,6248.65,3044.81656,6493.099602999981,3044.81656,6493.099602999981,42.25348574279477,985403.8769499984,2266060.538207535,2266060.538207535,985403.8769499984,29.39145569280757,50,85.71428571428571,5.564728120759099,-112.70922525878268,-118.27395337954178,42.25348574279477,22.60201757240474,28.213840151533777
1531612800,6248.65,6385.35,6233.26,6348.73,3882.98103,6232.219537499981,3882.98103,6232.219537499981,45.40403349765958,989286.8579799985,2268073.6426471137,2268073.6426471137,989286.8579799985,29.050030087402195,42.857142857142854,78.57142857142857,8.29896484598774,-107.90024732205711,-116.19921216804485,45.40403349765958,35.629027009436946,25.540297212278926
1531699200,6348.73,6750,6330.3,6728.81,9147.40957,6359.604177999981,9147.40957,6359.604177999981,55.36400164961163,998434.2675499985,2276297.3752631545,2276297.3752631545,998434.2675499985,27.123646370096694,35.714285714285715,71.42857142857143,34.89286970445448,-72.58312503747675,-107.47599474193123,55.36400164961163,85.10250569476084,47.77785009220084
1531785600,6728.8,7472.5,6663.51,7315.01,15644.42202,6795.729681999981,15644.42202,6795.729681999981,65.74385759884221,1014078.6895699985,2285850.6465299195,2285850.6465299195,1014078.6895699985,27.52885475252242,100,64.28571428571429,88.12202483116316,2.6765362970227216,-85.44548853414044,65.74385759884221,88.73050969953275,69.82068080124351
1531872000,7315,7584.85,7229.89,7378.99,15772.85857,7199.408023999982,15772.85857,7199.408023999982,66.65527296256997,1029851.5481399986,2283328.4821946896,2283328.4821946896,1029851.5481399986,28.14469569710919,100,57.142857142857146,121.727570228006,66.71397425086707,-55.013595977138934,66.65527296256997,86.36544269591477,86.73281936340278
1531958400,7378.99,7581,7281.42,7470.01,9985.49297,7157.925091999981,9985.49297,7157.925091999981,67.9612361063395,1039837.0411099986,2285915.0175257265,2285915.0175257265,1039837.0411099986,28.71654800279691,92.85714285714286,50,142.71994687255517,123.38633761355504,-19.333609259000134,67.9612361063395,92.39389604196471,89.16328281247074
1532044800,7470.01,7687,7259.76,7334.46,10399.41835,7344.406006499981,10399.41835,7344.406006499981,63.94466513154713,1029437.6227599985,2279152.1339137894,2279152.1339137894,1029437.6227599985,29.483720192232944,100,42.857142857142854,139.92172290952033,155.56854437790025,15.64682146837994,63.94466513154713,78.13013728373005,85.62982534053651
1532131200,7334.46,7444.77,7204.32,7408,5079.23425,7398.084259999981,5079.23425,7398.084259999981,65.14811829919918,1034516.8570099985,2282677.9188531428,2282677.9188531428,1034516.8570099985,29.913789738812994,92.85714285714286,35.714285714285715,135.3834243280341,184.87610187842256,49.49267755038847,65.14811829919918,82.69220032382334,84.40541121650604
1532217600,7408,7569.69,7327.75,7397.8,5599.23359,7269.215631499981,5599.23359,7269.215631499981,64.82492458121015,1028917.6234199986,2280321.0289266915,2280321.0289266915,1028917.6234199986,30.609565206954542,85.71428571428571,28.571428571428573,124.33972841998889,204.91733807537457,80.57760965538569,64.82492458121015,82.05944205609217,80.96059322121518
1532304000,7400,7809,7378.26,7720.09,12449.93653,7575.570064999981,12449.93653,7575.570064999981,69.90516577607255,1041367.5599499985,2287631.32736001,2287631.32736001,1041367.5599499985,31.760781538734502,100,21.428571428571427,130.73284393681223,243.993664576401,113.26082063958876,69.90516577607255,94.87251944936247,86.541387276426
1532390400,7720.08,8488,7695.99,8385.5,19634.15675,8220.69502949998,19634.15675,8220.69502949998,77.22032768830002,1061001.7166999986,2302183.4748755936,2302183.4748755936,1061001.7166999986,33.83309762112529,100,14.285714285714286,169.31902758130542,324.9096051162205,155.5905775349151,77.22032768830002,95.75215811089146,90.89470653878203
1532476800,8390.04,8482.84,8042,8157.15,14713.77448,8612.121354499981,14713.77448,8612.121354499981,70.85529451656166,1046287.9422199986,2295156.3492086413,2295156.3492086413,1046287.9422199986,35.75739112620246,92.85714285714286,7.142857142857143,168.63686361030963,366.38665704780215,197.7497934374925,70.85529451656166,86.28879522915551,92.30449092980314
1532563200,8157.15,8290,7840,7931.99,11869.53505,8944.891225499981,11869.53505,8944.891225499981,65.15265334080014,1034418.4071699986,2288139.6076219724,2288139.6076219724,1034418.4071699986,36.5866358858216,85.71428571428571,0,143.19704109450166,376.7460948056196,233.54905371111792,65.15265334080014,76.5046672892536,86.18187354310017
1532649600,7932,8276.55,7787.29,8184.21,11991.2855,9319.66663249998,11991.2855,9319.66663249998,68.23657947362162,1046409.6926699986,2295604.5664119613,2295604.5664119613,1046409.6926699986,37.11563791151506,78.57142857142857,0,133.71209670278643,400.68917458960095,266.9770778868145,68.23657947362162,86.79747935680139,83.19698062507017
1532736000,8182.64,8230,8065,8228.9,4141.06482,9360.64489899998,4141.06482,9360.64489899998,68.76405751223984,1050550.7574899986,2299690.4170343615,2299690.4170343615,1050550.7574899986,37.60685407823042,71.42857142857143,0,121.17574059239752,418.4467536273114,297.2710130349139,68.76405751223984,88.50865288237223,83.9369331761424
1532822400,8227.38,8289.96,8127.87,8216.34,4239.77486,9309.926628999983,4239.77486,9309.926628999983,68.42016304310798,1046310.9826299986,2300078.8472686205,2300078.8472686205,1046310.9826299986,38.18028272997199,64.28571428571429,0,103.45424995736198,426.58882548161637,323.1345755242544,68.42016304310798,87.40974185475275,87.57195803130878
1532908800,8216.33,8274.92,7850,8170.01,10568.95491,9429.480962999984,10568.95491,9429.480962999984,67.08737273831514,1035742.0277199986,2305428.9889450325,2305428.9889450325,1035742.0277199986,37.3848386222187,57.142857142857146,0,81.02089160807174,424.41069003434404,343.3897984262723,67.08737273831514,82.57101984664209,86.16313819458901
1532995200,8170,8173.57,7629.48,7727.27,12598.40527,9807.485461999982,12598.40527,9807.485461999982,55.884267259463066,1023143.6224499986,2297359.239049523,2297359.239049523,1023143.6224499986,35.753565907240954,50,0,31.327596458794005,382.5492939997648,351.2216975409708,55.884267259463066,40.738346005234995,70.23970256887661
1533081600,7727.28,7750,7437,7603.99,11853.40453,9929.582517499983,11853.40453,9929.582517499983,53.21927972876393,1011290.2179199986,2298153.757985751,2298153.757985751,1011290.2179199986,33.54630648568318,42.857142857142854,21.428571428571427,-12.530905364038176,335.5580658359231,348.0889711999613,53.21927972876393,31.134706468901907,51.481357440259664
1533168000,7603.99,7707.54,7462,7533.92,6917.3921,9976.677585499983,6917.3921,9976.677585499983,51.70988318155046,1004372.8258199985,2295288.649341253,2295288.649341253,1004372.8258199985,31.496708451379536,35.714285714285715,14.285714285714286,-47.00883827048938,289.32792336184957,336.33676163233895,51.70988318155046,25.676180979683433,32.51641115127345
1533254400,7533.92,7538.53,7285,7414.08,11084.7281,10378.673162499983,11084.7281,10378.673162499983,49.142751228058266,993288.0977199986,2295491.080182191,2295491.080182191,993288.0977199986,29.520446961382884,28.571428571428573,7.142857142857143,-76.86888457381099,240.25065591507519,317.1195404888862,49.142751228058266,16.340521002118923,24.383802816901426
1533340800,7414.08,7495,6940,7005,9933.76465,10681.212343499983,9933.76465,10681.212343499983,41.55830920078543,983354.3330699985,2287884.143288047,2287884.143288047,983354.3330699985,28.702411883252648,21.428571428571427,100,-120.5526373947144,166.4287437454932,286.9813811402076,41.55830920078543,4.198966408268734,15.405222796690369
1533427200,7005,7086.52,6880,7030.01,6243.61436,10536.022582999984,6243.61436,10536.022582999984,42.14618596173565,989597.9474299985,2290710.8813408264,2290710.8813408264,989597.9474299985,28.100713049220616,14.285714285714286,100,-142.63347361176517,108.68953912550114,251.3230127372663,42.14618596173565,9.328980099502502,9.95615583663006
1533513600,7030,7163,6840,6938,8955.57985,10201.580474499984,8955.57985,10201.580474499984,40.53087720995253,980642.3675799986,2287189.6471583187,2287189.6471583187,980642.3675799986,27.23514879683276,7.142857142857143,100,-157.15935878000968,54.8738142622542,212.03317304226388,40.53087720995253,5.946601941747573,6.491516149839611
1533600000,6938,7152,6647.07,6718.22,11144.03255,9970.139173499983,11144.03255,9970.139173499983,36.893525882175396,969498.3350299986,2279186.2397085605,2279186.2397085605,969498.3350299986,26.962192739131492,0,100,-173.98426102843356,-5.4471532432780805,168.53710778515548,36.893525882175396,3.875757856376372,6.3837799658754895
1533686400,6718.22,6718.22,6121.04,6282.5,22145.36492,10578.132770999984,22145.36492,10578.132770999984,30.96124537513478,947352.9701099986,2269015.792300812,2269015.792300812,947352.9701099986,27.836521062381593,0,100,-204.7523944661614,-87.40338529754627,117.34900916861514,30.96124537513478,7.444120684567721,5.755493494230563
1533772800,6282.5,6633.21,6177.51,6546.45,13980.61495,10757.192600999984,13980.61495,10757.192600999984,37.515764450215535,961333.5850599986,2277672.9130526027,2277672.9130526027,961333.5850599986,28.6483973625424,0,92.85714285714286,-197.52898172388944,-129.56221798624665,67.96676373764278,37.515764450215535,19.61390922671191,10.311262589218677
1533859200,6546.46,6584.8,6015,6146.01,8065.6933,10906.515553499983,8065.6933,10906.515553499983,32.47800228100557,953267.8917599985,2273316.193003684,2273316.193003684,953267.8917599985,29.70099206870677,14.285714285714286,100,-208.82147624508826,-193.06008156871758,15.7613946763707,32.47800228100557,5.7587825720012775,10.938937494426979
1533945600,6146.01,6485.76,6003,6235.56,10152.28236,11134.167991999984,10152.28236,11134.167991999984,34.59324063872903,963420.1741199985,2272945.2296661446,2272945.2296661446,963420.1741199985,30.700401094307967,7.142857142857143,100,-199.38144802491394,-233.46541535477172,-34.083967329857785,34.59324063872903,10.168957917934748,11.847216572215986
1534032000,6236,6482,6169.46,6316.01,8324.10149,10927.876239999985,8324.10149,10927.876239999985,36.51728320790459,971744.2756099985,2272427.470233862,2272427.470233862,971744.2756099985,31.628423760937647,0,92.85714285714286,-177.5678481743373,-256.0437775477794,-78.47592937344211,36.51728320790459,13.777333708933423,9.901691399623157
1534118400,6316,6544.99,6139.57,6253.67,10413.83369,10466.860086999985,10413.83369,10466.860086999985,35.64233248483511,961330.4419199985,2267875.3030824093,2267875.3030824093,961330.4419199985,32.161135820240574,0,85.71428571428571,-157.85004946342616,-275.7884912027248,-117.93844173929865,35.64233248483511,11.548579405409644,11.831623677425947
1534204800,6253.67,6258.32,5900,6195.01,17739.6612,10618.154422999985,17739.6612,10618.154422999985,34.797457233675715,943590.7807199985,2279346.277351331,2279346.277351331,943590.7807199985,33.160776602844805,0,100,-139.88487669962763,-292.7945376138332,-152.90966091420557,34.797457233675715,15.946486486486497,13.757466533609863
1534291200,6195,6636,6189,6269.01,17786.56031,10914.005685999986,17786.56031,10914.005685999986,36.831687406283926,961377.3410299985,2267927.066886535,2267927.066886535,961377.3410299985,32.37054232107009,0,92.85714285714286,-115.17510275594003,-296.8785393591306,-181.7034366031906,36.831687406283926,20.415039224581488,15.970035038825884
1534377600,6269.01,6475.01,6200,6315.9,8976.05548,10763.244184999985,8976.05548,10763.244184999985,38.14848521645249,970353.3965099985,2266516.7350539076,2266516.7350539076,970353.3965099985,31.63675334513642,0,85.71428571428571,-89.00086014781897,-292.9545117879643,-203.95365164014532,38.14848521645249,25.382507491470996,20.581344400846334
1534464000,6315.9,6585.5,6290.39,6585.49,10776.86869,11095.034378499986,10776.86869,11095.034378499986,45.21910050864317,981130.2651999985,2277292.873381081,2277292.873381081,981130.2651999985,30.4940618995988,0,78.57142857142857,-48.86576930521227,-265.0358632716607,-216.1700939664484,45.21910050864317,42.97742946708462,29.591658727712375
1534550400,6585.5,6613.23,6312,6396.64,6974.45619,11231.768444999985,6974.45619,11231.768444999985,41.62904464886004,974155.8090099985,2274237.800864165,2274237.800864165,974155.8090099985,29.31656715283208,0,71.42857142857143,-31.229431865662207,-255.20688379852618,-223.97745193286397,41.62904464886004,39.32224861441016,35.89406185765527
1534636800,6396.63,6547.34,6328.45,6489.53,4472.19056,10926.930227499985,4472.19056,10926.930227499985,43.984756528057424,978627.9995699985,2276347.733337696,2276347.733337696,978627.9995699985,28.22317917369156,7.142857142857143,64.28571428571429,-10.568236340834801,-237.18774735890747,-226.61951101807267,43.984756528057424,46.67695961995247,42.99221256714909
1534723200,6489.53,6525,6227.71,6258.74,7904.5958,10692.239753999986,7904.5958,10692.239753999986,39.698018817581435,970723.4037699985,2270093.2408554936,2270093.2408554936,970723.4037699985,27.552206709978133,0,57.142857142857146,-9.72662665595982,-238.77779433802243,-229.0511676820626,39.698018817581435,28.653354632587842,38.217520955650166
1534809600,6258.74,6490,6249.12,6475.89,6841.87611,10441.663332999986,6841.87611,10441.663332999986,45.117822811378495,977565.2798799984,2276133.5653886744,2276133.5653886744,977565.2798799984,26.929160850815663,0,50,7.256985303370442,-219.97993605284955,-227.23692135622,45.117822811378495,70.38327100290877,48.571195085149704
1534896000,6475.89,6890.65,6250,6359.99,17585.17524,10975.052489999987,17585.17524,10975.052489999987,42.90150123230157,959980.1046399984,2264586.612031598,2264586.612031598,959980.1046399984,25.40444386137921,100,42.857142857142854,12.196769490864483,-211.99095949263938,-224.18772898350386,42.90150123230157,46.43314995205168,48.489925195849445
1534982400,6359.99,6568.37,6348.69,6526.36,6998.98742,10770.765455999986,6998.98742,10770.765455999986,46.93143793543963,966979.0920599984,2268908.728898847,2268908.728898847,966979.0920599984,23.988635228331077,92.85714285714286,35.714285714285715,27.314777169963833,-190.04425752104908,-217.3590346910129,46.93143793543963,63.2271740776258,60.01453167752876
1535068800,6526.36,6725,6451.55,6690.88,7427.5564,10645.455043499987,7427.5564,10645.455043499987,50.64136239204263,974406.6484599984,2274482.7235920047,2274482.7235920047,974406.6484599984,23.2486186923299,85.71428571428571,28.571428571428573,47.839468624339986,-157.55969891058794,-205.39916753492793,50.64136239204263,79.83445212739115,63.16492538568955
1535155200,6690.88,6790,6668,6737.52,4930.18051,10579.783350999987,4930.18051,10579.783350999987,51.6728021893325,979336.8289699984,2275171.3324107784,2275171.3324107784,979336.8289699984,22.787782129852587,78.57142857142857,21.428571428571427,63.0451644459535,-126.59271197748603,-189.63787642343954,51.6728021893325,84.54247211426849,75.86803277309515
1535241600,6737.52,6773,6572,6709.98,5009.1171,10382.460213499986,5009.1171,10382.460213499986,50.99516104735351,974327.7118699984,2277039.4091163306,2277039.4091163306,974327.7118699984,21.899923107665114,71.42857142857143,14.285714285714286,69.24222216534031,-103.08509871676415,-172.32732088210446,50.99516104735351,81.76247918033613,82.04646780733192
1535328000,6709.98,6947.6,6654.13,6911.9,7307.57955,10190.637563499986,7307.57955,10190.637563499986,55.593340740041484,981635.2914199984,2282569.0857124683,2282569.0857124683,981635.2914199984,21.699514194870492,100,7.142857142857143,83.9537641517947,-67.38511569236107,-151.33887984415577,55.593340740041484,96.59221076746844,87.63238735402437
1535414400,6911.9,7128,6864.96,7071.01,11880.47054,9677.392844499987,11880.47054,9677.392844499987,58.868443554042926,993515.7619599984,2289301.5330158914,2289301.5330158914,993515.7619599984,22.07879624939198,100,0,100.3074347846386,-25.95458636335752,-126.26202114799612,58.868443554042926,93.93077742279023,90.76182245686495
1535500800,7071.01,7119,6907.42,7030.9,7710.55401,9363.889797499987,7710.55401,9363.889797499987,57.71289143377375,985805.2079499984,2290590.8770033848,2290590.8770033848,985805.2079499984,22.43098672859051,92.85714285714286,0,103.8906974822508,3.601350704817378,-100.28934677743342,57.71289143377375,89.53663793103445,93.35320870709772
1535587200,7030.92,7048.66,6790,6983,8325.65062,9376.887663499987,8325.65062,9376.887663499987,56.29180754969241,977479.5573299985,2294689.648943193,2294689.648943193,977479.5573299985,22.134107212628003,85.71428571428571,0,98.54794782267531,22.89558800091072,-75.65235982176459,56.29180754969241,83.8940785746815,89.12049797616874
1535673600,6983,7090.46,6884.49,7015.01,7855.33617,9262.040353999986,7855.33617,9262.040353999986,57.05286238422107,985334.8934999985,2296789.922589267,2296789.922589267,985334.8934999985,22.008388687860872,78.57142857142857,21.428571428571427,92.7656811172223,40.304741574763284,-52.460939542459016,57.05286238422107,87.44959957347079,86.96010535972891
1535760000,7015.01,7275,7010.98,7191.08,6276.19998,9159.645278499986,6276.19998,9159.645278499986,61.06836672510332,991611.0934799985,2299076.283145575,2299076.283145575,991611.0934799985,22.51068406342343,100,14.285714285714286,95.99319051545349,67.53054860185784,-28.462641913595643,61.06836672510332,91.98693771543698,87.77687195452977
1535846400,7191.07,7328.99,7130,7295,5891.98418,8933.552802999986,5891.98418,8933.552802999986,63.25227688405421,997503.0776599986,2302955.4170086924,2302955.4170086924,997503.0776599986,23.145149648222592,100,7.142857142857143,99.87542930818887,96.38164472164044,-3.4937845865484256,63.25227688405421,96.91359145721344,92.11670958204041
1535932800,7294.99,7339.52,7192.99,7256.98,6133.09184,8353.224334999986,6133.09184,8353.224334999986,61.88451100263797,991369.9858199985,2302178.996796913,2302178.996796913,991369.9858199985,23.76818669361424,100,0,94.67861092017814,114.85447906367426,20.175868143496114,61.88451100263797,92.43030080704321,93.77694332656455
1536019200,7256.48,7402.5,7229.94,7360,7999.78386,7863.885512499985,7999.78386,7863.885512499985,64.14684684188822,999369.7696799985,2306238.228801906,2306238.228801906,999369.7696799985,24.554257882542515,100,0,92.84869278811867,136.23673412864446,43.38804134052579,64.14684684188822,96.31236442516268,95.21875222980646
1536105600,7359.99,7384,6664.07,6687.96,16381.47297,8234.156386999985,16381.47297,8234.156386999985,45.270156963182615,982988.2967099985,2290943.954279681,2290943.954279681,982988.2967099985,23.128570645874245,92.85714285714286,0,43.55087037032871,97.82662930343668,54.275758933107966,45.270156963182615,32.19460813619156,73.64575778946583
1536192000,6687.96,6703.73,6272.73,6495,18836.77833,8637.151868999985,18836.77833,8637.151868999985,41.494457093012905,964151.5183799985,2291535.717571069,2291535.717571069,964151.5183799985,23.022355377578798,85.71428571428571,100,-2.44013639694699,51.22558843692423,53.66572483387122,41.494457093012905,19.67391592979105,49.39362949704844
1536278400,6495,6530,6325,6395.01,8366.04392,8706.731255499984,8366.04392,8706.731255499984,39.64904989269006,955785.4744599985,2288883.8856982808,2288883.8856982808,955785.4744599985,22.923726914161602,78.57142857142857,92.85714285714286,-38.00888083730362,6.15462378724169,44.16350462454531,39.64904989269006,10.823441939509866,20.897322001830833
1536364800,6395.01,6460,6116,6188,7581.70232,8862.206843499986,7581.70232,8862.206843499986,36.072248855145304,948203.7721399985,2284475.9192331643,2284475.9192331643,948203.7721399985,23.389851260902013,71.42857142857143,100,-71.92371725972751,-45.74114195011407,26.182575309613433,36.072248855145304,5.596579867858531,12.031312579053163
1536451200,6188,6450,6147,6235.01,6356.68825,8784.811465999986,6356.68825,8784.811465999986,37.452181144628064,954560.4603899985,2281811.984335524,2281811.984335524,954560.4603899985,23.82268101144668,64.28571428571429,92.85714285714286,-86.64915274788929,-82.12886562524818,4.520287122641108,37.452181144628064,9.250680139914513,8.556900649094317
1536537600,6235.02,6375.13,6221.49,6300,7028.6689,8794.151105499985,7028.6689,8794.151105499985,39.39971052331098,961589.1292899986,2281966.611391512,2281966.611391512,961589.1292899986,24.224594351238157,57.142857142857146,85.71428571428571,-87.23017928813717,-104.51743698753035,-17.287257699393184,39.39971052331098,14.302370773416246,9.716543593729776
1536624000,6300,6390,6176.76,6282.53,7184.86319,8274.135502999985,7184.86319,8274.135502999985,39.047746017180316,954404.2660999986,2281909.3319532126,2281909.3319532126,954404.2660999986,24.72854060234877,50,78.57142857142857,-83.97889528618471,-122.26087680712408,-38.28198152093937,39.047746017180316,12.944422852701107,12.165824588677301
1536710400,6282.53,6340.94,6191.1,6326,7428.6959,8295.620926999985,7428.6959,8295.620926999985,40.47270833726777,961832.9619999987,2287856.6514951508,2287856.6514951508,961832.9619999987,25.19649069266577,42.857142857142854,71.42857142857143,-74.4155776378591,-131.30145356826324,-56.88587593040414,40.47270833726777,16.323357947920716,14.523383858012702
1536796800,6326,6530,6323.64,6485.99,9793.80167,8413.933190499985,9793.80167,8413.933190499985,45.52085299076216,971626.7636699986,2293473.042702884,2293473.042702884,971626.7636699986,24.57301142394618,35.714285714285715,64.28571428571429,-53.79168215596275,-124.12547862535757,-70.33379646939483,45.52085299076216,28.759424795958008,19.34240186552662
1536883200,6485.99,6580,6378.05,6478.04,7690.51159,8551.949744499985,7690.51159,8551.949744499985,45.31520777206077,963936.2520799986,2293398.0226096315,2293398.0226096315,963936.2520799986,23.73505794610428,28.571428571428573,57.142857142857146,-37.91130578448414,-117.72292870000001,-79.81162291551587,45.31520777206077,28.141469102215314,24.408083948698025
1536969600,6478.05,6565,6470,6518.68,3404.13202,8471.700490499985,3404.13202,8471.700490499985,46.64222687617042,967340.3840999986,2293482.588415602,2293482.588415602,967340.3840999986,22.95695828810823,21.428571428571427,50,-22.649243045197977,-108.12317672201334,-85.47393367681536,46.64222687617042,31.300427516517708,29.400440471563687
1537056000,6518.68,6521.75,6323.68,6498,3520.81645,8282.362335499985,3520.81645,8282.362335499985,46.03011029658667,963819.5676499986,2296159.063060306,2296159.063060306,963819.5676499986,22.82940815159393,14.285714285714286,42.857142857142854,-12.43646679892909,-101.01951717547672,-88.58305037654763,46.03011029658667,29.692965410027206,29.71162067625342
1537142400,6498,6529.75,6207.55,6250.7,9334.44843,8155.061229999985,9334.44843,8155.061229999985,39.3752826082139,954485.1192199986,2289324.809849142,2289324.809849142,954485.1192199986,23.13617163103321,7.142857142857143,35.714285714285715,-20.357869863076274,-114.03038770539297,-93.6725178423167,39.3752826082139,10.470268169451987,23.821220365332312
1537228800,6250.71,6384.04,6228,6335.7,6136.55992,8076.361525499985,6136.55992,8076.361525499985,42.45480494523775,960621.6791399986,2291659.2509978935,2291659.2509978935,960621.6791399986,23.421023433369687,0,28.571428571428573,-17.97716277343568,-116.1439713091113,-98.16680853567561,42.45480494523775,17.32649842271292,19.163244000730717
1537315200,6335.69,6511,6106.37,6386.94,10747.39416,8197.448702499985,10747.39416,8197.448702499985,44.29188046102767,971369.0732999987,2295816.319579021,2295816.319579021,971369.0732999987,22.892076974138195,0,100,-11.377603964130955,-112.38881349083931,-101.01120952670836,44.29188046102767,46.96832730681664,24.921697966327198
1537401600,6386.95,6530,6337,6493.11,6819.61785,8145.6627864999855,6819.61785,8145.6627864999855,47.996374850302345,978188.6911499987,2300028.9353307155,2300028.9353307155,978188.6911499987,22.285830360850728,0,92.85714285714286,1.0517257266748459,-99.69655236836479,-100.74827809503964,47.996374850302345,81.65445600996551,48.64976057983171
1537488000,6493.11,6777.1,6492.5,6750,11391.36526,8401.421050499985,11391.36526,8401.421050499985,55.676594313768035,989580.0564099987,2309250.8979305187,2309250.8979305187,989580.0564099987,20.99569526412203,100,85.71428571428571,26.09967805861318,-68.12368052177317,-94.22335858038635,55.676594313768035,95.95962607904815,74.86080313194346
1537574400,6750,6823,6628.01,6707.33,5315.80099,8372.611890999984,5315.80099,8372.611890999984,54.24358657473391,984264.2554199987,2308259.9272859395,2308259.9272859395,984264.2554199987,20.013521149240816,100,78.57142857142857,38.566977728713624,-46.01463641949431,-84.58161414820793,54.24358657473391,83.8591741903074,87.15775209310704
1537660800,6707.34,6777,6660.05,6696.99,3506.52668,8241.283632999985,3506.52668,8241.283632999985,53.88167742696251,980757.7287399987,2306968.554014391,2306968.554014391,980757.7287399987,19.10150232827969,92.85714285714286,71.42857142857143,44.470734715858754,-28.993195753384498,-73.46393046924325,53.88167742696251,82.41630967165759,87.41170331367107
1537747200,6696.99,6716.16,6555.99,6582.09,5562.1461,8119.401744999986,5562.1461,8119.401744999986,49.89770853586569,975195.5826399986,2303219.132060111,2303219.132060111,975195.5826399986,17.80630226537856,85.71428571428571,64.28571428571429,39.17697288082093,-24.492714368217094,-63.66968724903802,49.89770853586569,66.38293121973686,77.55280502723396
1537833600,6582.09,6582.1,6320.5,6436.89,9518.35072,7776.245632499985,9518.35072,7776.245632499985,45.33579224898525,965677.2319199987,2302170.5125350715,2302170.5125350715,965677.2319199987,17.71628668713116,78.57142857142857,57.142857142857146,25.119363463389618,-32.270482919801,-57.389846383190616,45.33579224898525,46.121429468484486,64.97355678662633
1537920000,6435,6537.26,6380.62,6455.66,5910.05641,7129.909536499984,5910.05641,7129.909536499984,46.02279650840706,971587.2883299986,2301923.0025117723,2301923.0025117723,971587.2883299986,17.63270079304429,71.42857142857143,50,16.712597505739907,-36.499099501015735,-53.21169700675564,46.02279650840706,48.74063324170073,53.74833130997404
1538006400,6455.65,6734.79,6430,6680.01,7878.88861,7105.551770999984,7878.88861,7105.551770999984,53.53889392921496,979466.1769399986,2306969.7409983706,2306969.7409983706,979466.1769399986,16.450283742445958,64.28571428571429,42.857142857142854,25.36991125398214,-21.49930793927797,-46.86921919326011,53.53889392921496,80.04688611975499,58.30298294331342
1538092800,6680.01,6786.73,6528.13,6620.01,9036.03829,7178.268569499984,9036.03829,7178.268569499984,51.4745391037073,970430.1386499986,2304354.670984358,2304354.670984358,970430.1386499986,15.459705997949186,57.142857142857146,35.714285714285715,26.064453017396275,-14.288652921514768,-40.35310593891104,51.4745391037073,71.67436473493996,66.8206280321319
1538179200,6620.01,6620.01,6452.02,6581,4371.92981,7079.030647499983,4371.92981,7079.030647499983,50.12138457625538,966058.2088399986,2306696.1349108163,2306696.1349108163,966058.2088399986,14.567162800631106,50,28.571428571428573,23.011801141144282,-11.588354512480691,-34.600155653624974,50.12138457625538,66.23083041457936,72.65069375642479
1538265600,6581,6642.28,6523,6605,3698.73537,6912.533970999984,3698.73537,6912.533970999984,50.97525166777344,969756.9442099986,2308082.850586088,2308082.850586088,969756.9442099986,13.615171385662721,42.857142857142854,21.428571428571427,21.739208389916286,-7.426145166229617,-29.165353556145902,50.97525166777344,69.57983896850537,69.16167803934157
1538352000,6605,6639.33,6474.9,6572.83,7146.47531,6910.614576999984,7146.47531,6910.614576999984,49.74595097435009,962610.4688999986,2309448.8648109455,2309448.8648109455,962610.4688999986,12.995738402609321,35.714285714285715,14.285714285714286,18.014847397708603,-6.646794309010147,-24.66164170671875,49.74595097435009,65.09077208601369,66.96714715636615
1538438400,6572.83,6591.37,6452,6498.46,5444.05081,6811.382322499984,5444.05081,6811.382322499984,46.92843600213692,957166.4180899985,2307634.4416199825,2307634.4416199825,957166.4180899985,12.548643688632902,28.571428571428573,7.142857142857143,10.21483783377176,-11.893094414504048,-22.10793224827581,46.92843600213692,54.713031829535474,63.12788096135153
1538524800,6498.47,6507.95,6398.96,6466.03,6234.36988,6633.410732999984,6234.36988,6633.410732999984,45.71259108297007,950932.0482099985,2309073.054359518,2309073.054359518,950932.0482099985,12.432873808537858,21.428571428571427,0,2.922411232594648,-18.4549182075325,-21.37732944012715,45.71259108297007,28.961194029850695,49.58833264846664
1538611200,6466.03,6603.01,6454.38,6547.45,6670.55838,6582.413072499983,6670.55838,6582.413072499983,49.266495929717145,957602.6065899985,2310756.514258824,2310756.514258824,957602.6065899985,11.692935923683244,14.285714285714286,35.714285714285715,3.5893891108557057,-16.890593051557516,-20.479982162413222,49.266495929717145,45.164179104477576,42.94613498795459
1538697600,6547.45,6641,6510.58,6593.94,5344.82622,6679.447782499983,5344.82622,6679.447782499983,51.229742563789635,962947.4328099985,2312244.14799434,2312244.14799434,962947.4328099985,10.951748276226247,7.142857142857143,28.571428571428573,6.9728714940388485,-11.76389279486466,-18.736764288903508,51.229742563789635,54.415920398009874,42.84709784411272
1538784000,6593.94,6594.39,6536,6552.43,2725.27095,6639.670507499983,2725.27095,6639.670507499983,49.39187837490602,960222.1618599985,2311052.5712285666,2311052.5712285666,960222.1618599985,10.26350260358761,0,21.428571428571427,6.249791535448111,-10.92452486959337,-17.17431640504148,49.39187837490602,49.745833601441454,49.77531103464298
1538870400,6552.42,6585.01,6491.81,6570,2625.51246,6304.223708999983,2625.51246,6304.223708999983,50.20615250707637,962847.6743199985,2312832.398237395,2312832.398237395,962847.6743199985,9.746709772585275,35.714285714285715,14.285714285714286,6.746805943863887,-8.740808975211621,-15.487614919075508,50.20615250707637,53.51435986530258,52.558704621584646
1538956800,6569.99,6681.19,6545.63,6608.07,5447.89003,6269.7902144999825,5447.89003,6269.7902144999825,52.007988155087055,968295.5643499985,2312403.19002317,2312403.19002317,968295.5643499985,9.506342715412744,28.571428571428573,7.142857142857143,9.275382320574554,-3.8933870183573163,-13.16876933893187,52.007988155087055,61.67985758102224,54.9800170159221
1539043200,6607.53,6612.86,6552.5,6589.48,4580.92412,5961.466712499982,4580.92412,5961.466712499982,51.03679836343782,963714.6402299985,2313435.3399242964,2313435.3399242964,963714.6402299985,9.283144733752538,21.428571428571427,0,9.307700924740974,-1.5341431830056536,-10.841844107746628,51.03679836343782,51.429415675555845,55.5412110406269
1539129600,6589.48,6591.32,6445.48,6524.56,6387.6863,5939.870134999983,6387.6863,5939.870134999983,47.68772642157771,957326.9539299986,2313974.9469951685,2313974.9469951685,957326.9539299986,8.96541703504364,14.285714285714286,0,4.7958328251575075,-4.847053076299744,-9.642885901457252,47.68772642157771,32.390334476622876,48.49986924440034
1539216000,6524.56,6524.56,6033.34,6154.69,20730.65656,6406.834699999983,20730.65656,6406.834699999983,33.999012731785754,936596.2973699985,2303486.809768893,2303486.809768893,936596.2973699985,10.738455482458223,7.142857142857143,100,-21.79985113782495,-36.89269982373844,-15.09284868591349,33.999012731785754,16.107195476446403,33.308981876208385
1539302400,6154.68,6235.2,6111.97,6188.01,5566.78707,6419.384003999983,5566.78707,6419.384003999983,35.78722083393792,942163.0844399985,2304790.078510023,2304790.078510023,942163.0844399985,12.384848326486052,0,92.85714285714286,-35.062723203708,-58.9212526905485,-23.858529486840492,35.78722083393792,23.87435363124183,24.123961194770377
1539388800,6188.01,6212,6178,6196,3842.8736,6436.201349999983,3842.8736,6436.201349999983,36.233377627117434,946005.9580399985,2305016.1298982585,2305016.1298982585,946005.9580399985,13.913641681654749,64.28571428571429,85.71428571428571,-40.81017178829011,-74.87124422220313,-34.06107243391302,36.233377627117434,25.107663811067376,21.69640430625188
1539475200,6196.01,6288.45,6151,6183.49,3762.54542,6346.221315999983,3762.54542,6346.221315999983,35.81380063185374,942243.4126199986,2303032.341854698,2303032.341854698,942243.4126199986,14.704003427505993,57.142857142857146,78.57142857142857,-42.76105525243479,-87.5123914994565,-44.75133624702171,35.81380063185374,23.176661264181487,24.052892902163574
1539561600,6183.52,6810,6151.58,6440.42,21436.32406,6942.119982999982,21436.32406,6942.119982999982,48.90125721253473,963679.7366799986,2300403.67200171,2300403.67200171,963679.7366799986,14.78004666529637,100,71.42857142857143,-24.93756428228302,-75.92329159987548,-50.98572731759246,48.90125721253473,52.41418381273659,33.56616962932849
1539648000,6440.43,6493.11,6375,6457.11,10080.3628,7150.635302499983,10080.3628,7150.635302499983,49.6198767524364,973760.0994799986,2304339.033348827,2304339.033348827,973760.0994799986,14.85065824324458,92.85714285714286,64.28571428571429,-10.92893316079109,-64.64689376858132,-53.71796060779023,49.6198767524364,54.563129297247144,43.384658124721746
1539734400,6457.1,6459.99,6411.19,6443.7,5507.28108,7032.0549259999825,5507.28108,7032.0549259999825,49.023324227259515,968252.8183999986,2306169.5271832044,2306169.5271832044,968252.8183999986,14.91622613705363,85.71428571428571,57.142857142857146,-1.9417403094183214,-56.145135994563134,-54.20339568514481,49.023324227259515,52.83650503437795,53.271272714787244
1539820800,6443.69,6489.83,6355,6394.96,7212.22828,6940.864425499984,7212.22828,6940.864425499984,46.82006087091341,961040.5901199986,2303232.3214066355,2303232.3214066355,961040.5901199986,14.62957769603625,78.57142857142857,50,1.176736372027655,-52.732475220110246,-53.9092115921379,46.82006087091341,46.560914685962956,51.320183005862695
1539907200,6394.96,6409.61,6353.86,6382.99,3816.4999,6913.0929299999825,3816.4999,6913.0929299999825,46.27006794864145,957224.0902199985,2303404.1494738823,2303404.1494738823,957224.0902199985,14.356136713060923,71.42857142857143,42.857142857142854,2.7972332317646575,-50.41267005243208,-53.209903284196734,46.27006794864145,45.01969973991189,48.13903982008427
1539993600,6382.99,6420,6369,6414,3425.85726,6899.4490244999815,3425.85726,6899.4490244999815,47.975085298915175,960649.9474799985,2306023.9226727057,2306023.9226727057,960649.9474799985,14.159085978836956,64.28571428571429,35.714285714285715,6.130383967340954,-45.54692332502054,-51.6773072923615,47.975085298915175,49.01243787500321,46.864350766959355
1540080000,6413.99,6452.87,6405.57,6415.88,2611.80516,6672.715516999982,2611.80516,6672.715516999982,48.08264901626733,963261.7526399984,2304550.709952435,2304550.709952435,963261.7526399984,14.162432813218212,57.142857142857146,28.571428571428573,8.489282771224637,-41.0657038283307,-49.554986599555335,48.08264901626733,49.25450003862695,47.76221255118069
1540166400,6415.87,6427.63,6377.77,6407.65,4004.84065,6600.755008999983,4004.84065,6600.755008999983,47.61850066485992,959256.9119899984,2305345.8949190415,2305345.8949190415,959256.9119899984,13.952039019543447,50,21.428571428571427,9.449336591687427,-37.74331585994605,-47.19265245163348,47.61850066485992,48.19483429042304,48.8205907346844
1540252800,6407.64,6411.5,6360,6395.14,4036.6401,6490.868519999984,4036.6401,6490.868519999984,46.87774111325774,955220.2718899985,2306817.896881721,2306817.896881721,955220.2718899985,13.616082917463226,42.857142857142854,14.285714285714286,9.187617318353702,-35.70813080369135,-44.89574812204505,46.87774111325774,46.58409085056527,48.011141726538426
1540339200,6395.13,6471,6395.13,6415.98,5191.43397,6416.912299499983,5191.43397,6416.912299499983,48.32001910323221,960411.7058599985,2304479.8014717447,2304479.8014717447,960411.7058599985,13.692977026935512,35.714285714285715,7.142857142857143,10.281212746272686,-32.044232189204195,-42.32544493547688,48.32001910323221,49.26737568562814,48.01543360887215
1540425600,6415.97,6422,6377.5,6395.58,3747.23864,6337.0329204999825,3747.23864,6337.0329204999825,46.975518021097926,956664.4672199985,2303777.510005282,2303777.510005282,956664.4672199985,13.61050881963351,28.571428571428573,0,9.511691673350029,-30.43583034378935,-39.94752201713938,46.975518021097926,40.6300588799908,45.49384180539474
1540512000,6395.58,6450,6383.54,6404.87,4134.90903,6407.514824499982,4134.90903,6407.514824499982,47.68934741408027,960799.3762499985,2302296.757147713,2302296.757147713,960799.3762499985,13.728374878239746,21.428571428571427,0,9.487812207886975,-28.08775675728066,-37.57556896516763,47.68934741408027,38.5235204855842,42.80698501706772
1540598400,6404.87,6421.76,6390,6409.12,2332.73006,6392.875704499982,2332.73006,6392.875704499982,48.034010752963034,963132.1063099984,2302772.704590685,2302772.704590685,963132.1063099984,13.837821932659825,14.285714285714286,7.142857142857143,9.589272588689212,-25.58897822930612,-35.178250817995334,48.034010752963034,39.16843702579664,39.44067213045722
1540684800,6409.11,6415,6380.01,6403.62,2141.97166,6227.579785999982,2141.97166,6227.579785999982,47.596949291737616,960990.1346499984,2303521.3845964526,2303521.3845964526,960990.1346499984,13.834768188010052,7.142857142857143,0,9.11989672191445,-23.778379915602272,-32.89827663751672,47.596949291737616,38.279517633121706,38.65715838150086
1540771200,6403.63,6414.99,6211,6266,6985.61299,6347.8142294999825,6985.61299,6347.8142294999825,38.224743958591084,954004.5216599983,2300302.708362666,2300302.708362666,954004.5216599983,13.390038268849441,0,0,-0.13503862034619374,-33.067074912949465,-32.93203629260327,38.224743958591084,19.49594129949313,32.314631986137165
1540857600,6266,6289,6240.54,6267.63,4101.14426,6233.487127499982,4101.14426,6233.487127499982,38.379511025365396,958105.6659199983,2300786.7889480395,2300786.7889480395,958105.6659199983,12.977074772486016,0,92.85714285714286,-5.524515966632656,-39.83768125089409,-34.31316528426144,38.379511025365396,20.30986622673318,26.028441719782673
1540944000,6267.63,6353.24,6201.67,6304.18,5228.93707,5458.4011529999825,5228.93707,5458.4011529999825,41.89481851794151,963334.6029899983,2302630.7335702702,2302630.7335702702,963334.6029899983,12.095179404858595,7.142857142857143,100,-5.967569509331788,-41.77262717092617,-35.80505766159438,41.89481851794151,35.573986674070056,25.126598066765453
1541030400,6304.18,6360,6293.44,6344,4491.04326,5404.613962499982,4491.04326,5404.613962499982,45.5399623892037,967825.6462499982,2304962.6214168086,2304962.6214168086,967825.6462499982,11.337332955466872,0,92.85714285714286,-3.064789782566237,-39.63604488980218,-36.57125510723594,45.5399623892037,52.845951063750775,36.24326798818467
1541116800,6344,6378.77,6333.94,6349.8,4182.83962,5421.612263499982,4182.83962,5421.612263499982,46.07064693921698,972008.4858699982,2303739.399747877,2303739.399747877,972008.4858699982,10.810080563600891,35.714285714285715,85.71428571428571,-0.3811667391729543,-37.047713531202135,-36.66654679202918,46.07064693921698,54.999443062414194,47.806460266745006
1541203200,6349.8,6351.7,6315.91,6331.96,2572.97615,5362.133799999982,2572.97615,5362.133799999982,44.63006628318636,969435.5097199982,2303474.122240375,2303474.122240375,969435.5097199982,10.132733426947338,28.571428571428573,78.57142857142857,0.516632369891795,-36.02075632966444,-36.53738869955623,44.63006628318636,48.3755987079048,52.07366427802325
1541289600,6331.96,6464.15,6313.17,6423.28,4055.57082,4493.096137999982,4055.57082,4493.096137999982,52.77105653111571,973491.0805399982,2305334.0223832866,2305334.0223832866,973491.0805399982,10.526981951194683,21.428571428571427,71.42857142857143,7.213206193899168,-27.52088095718227,-34.73408715108144,52.77105653111571,82.28195893513524,61.88566690181807
1541376000,6423.29,6439.99,6372,6404,4088.6935,4193.512672999981,4088.6935,4193.512672999981,51.06401533212946,969402.3870399982,2305094.076993303,2305094.076993303,969402.3870399982,10.893069866567217,14.285714285714286,64.28571428571429,10.118620228649526,-22.085811865269534,-32.20443209391906,51.06401533212946,75.12345449819922,68.59367071374642
1541462400,6404,6449.65,6387.82,6448.5,5512.14007,4193.755622499981,5512.14007,4193.755622499981,54.70591028096611,974914.5271099982,2310401.1722280937,2310401.1722280937,974914.5271099982,11.318908641195126,7.142857142857143,57.142857142857146,14.542730365796597,-14.026019136673312,-28.56874950246991,54.70591028096611,91.64593621208184,83.01711654847209
1541548800,6448.5,6540,6448.5,6503.12,5833.03647,4124.796031999982,5833.03647,4124.796031999982,58.76255692675991,980747.5635799982,2311532.0800639167,2311532.0800639167,980747.5635799982,12.460116867582382,100,50,20.299499567647203,-3.194375042910906,-23.49387461055811,58.76255692675991,89.09939999408857,85.28959690145655
1541635200,6503.12,6511.88,6388,6406.24,5335.806,4200.761336999982,5335.806,4200.761336999982,50.17819876361488,975411.7575799982,2307767.5543583953,2307767.5543583953,975411.7575799982,12.764795390533362,92.85714285714286,42.857142857142854,16.8751315651294,-2.399960154146356,-19.275091719275757,50.17819876361488,60.464635119557755,80.40332377524273
1541721600,6406.24,6415,6305,6334.89,4588.15732,4258.876339999982,4588.15732,4258.876339999982,44.96798972335217,970823.6002599982,2305672.8519892097,2305672.8519892097,970823.6002599982,12.136626806567262,85.71428571428571,35.714285714285715,9.46651877923038,-7.4419432452377805,-16.90846202446816,44.96798972335217,39.37575739662468,62.979930836757
1541808000,6334.89,6374,6327.46,6347.42,2421.64504,4249.368333999982,2421.64504,4249.368333999982,46.02785708701523,973245.2452999982,2305328.3893728624,2305328.3893728624,973245.2452999982,11.553327407170165,78.57142857142857,28.571428571428573,5.2804798049929875,-10.307862268226927,-15.588342073219914,46.02785708701523,43.07924216002129,47.63987822540124
1541894400,6347.42,6360,6271.15,6357.6,2363.46581,4167.299591999981,2363.46581,4167.299591999981,46.92225341729684,975608.7111099982,2307564.172167803,2307564.172167803,975608.7111099982,11.032460060030903,71.42857142857143,21.428571428571427,3.1717199528277966,-11.62369213218517,-14.795412085012966,46.92225341729684,46.088138799397136,42.8477127853477
1541980800,6357.6,6383.59,6305.95,6327.87,3731.14507,4152.024840499981,3731.14507,4152.024840499981,44.59787757765405,971877.5660399982,2305939.8457462937,2305939.8457462937,971877.5660399982,10.291961995038132,64.28571428571429,14.285714285714286,-0.07868886750343584,-14.893773169392261,-14.815084301888826,44.59787757765405,37.30086010699608,42.156080355471495
1542067200,6327.87,6328.22,6252.5,6259.34,4686.80276,4126.793279999982,4686.80276,4126.793279999982,39.714231718224866,967190.7632799982,2302099.787066547,2302099.787066547,967190.7632799982,10.15509694050581,57.142857142857146,7.142857142857143,-6.35021535053642,-22.75285349005935,-16.40263813952293,39.714231718224866,17.045488132888035,33.47816234642708
1542153600,6259.35,6293.38,5280.93,5605.46,32732.1207,5576.037382999982,32732.1207,5576.037382999982,18.687240059922203,934458.6425799982,2290351.527556277,2290351.527556277,934458.6425799982,13.974964453189745,50,100,-51.52775216469922,-80.81232834539696,-29.284576180697737,18.687240059922203,25.775373887075368,26.70724070898649
1542240000,5605.01,5645,5188,5579.52,21892.94986,6463.939424499981,21892.94986,6463.939424499981,18.273889460583973,912565.6927199982,2305970.7340603345,2305970.7340603345,912565.6927199982,17.673916198073275,42.857142857142854,100,-78.53143539976209,-127.44887043040035,-48.91743503063826,18.273889460583973,28.95857988165684,23.926480633873407
1542326400,5579.5,5609.91,5410,5512.24,9359.72857,6815.289349999982,9359.72857,6815.289349999982,17.21055710252452,903205.9641499982,2306184.7001428963,2306184.7001428963,903205.9641499982,21.108657104036553,35.714285714285715,92.85714285714286,-95.18775479651464,-167.90212852628156,-72.71437372976692,17.21055710252452,23.982248520710044,26.23873409648074
1542412800,5512.26,5544,5450.83,5504.17,4784.3283,6947.407181999981,4784.3283,6947.407181999981,17.0821606356386,898421.6358499981,2306878.4457190796,2306878.4457190796,898421.6358499981,24.298059373859594,28.571428571428573,85.71428571428571,-100.48979919279486,-198.3266227207605,-97.83682352796563,17.0821606356386,23.385355029585803,25.44206114398422
1542499200,5503.34,5665,5503.34,5560,4724.6979,6834.361427499981,4724.6979,6834.361427499981,21.448251576535114,903146.3337499981,2305465.6540793045,2305465.6540793045,903146.3337499981,26.231280350658416,21.428571428571427,78.57142857142857,-94.09027676186834,-215.44966948030105,-121.35939271843272,21.448251576535114,27.514792899408285,24.960798816568033
1542585600,5560,5560,4670.05,4733.5,41592.0324,8708.905834499981,41592.0324,8708.905834499981,11.660022774265471,861554.3013499981,2269804.324428403,2269804.324428403,861554.3013499981,29.387499692701542,14.285714285714286,100,-136.78570102420068,-292.34151899868357,-155.5558179744829,11.660022774265471,3.3931388539800436,18.097762260991367
1542672000,4736.67,4889,4035,4349.23,66596.8464,11777.30130099998,66596.8464,11777.30130099998,9.491250473436509,794957.4549499981,2252216.2064693207,2252216.2064693207,794957.4549499981,32.83238498515229,7.142857142857143,100,-179.4808743043993,-379.906910854982,-200.42603655058272,9.491250473436509,12.544111776447089,14.484014509945128
1542758400,4349.24,4627.55,4239.01,4545.11,28516.21931,12978.56010349998,28516.21931,12978.56010349998,17.876575628520882,823473.674259998,2268631.3441922697,2268631.3441922697,823473.674259998,36.03120704242798,0,92.85714285714286,-182.50484785847564,-428.55709637367727,-246.05224851520163,17.876575628520882,20.59486127709052,12.177370635839205
1542844800,4545.12,4589,4238.69,4265.36,13038.218,13421.32902249998,13038.218,13421.32902249998,15.646986967047283,810435.456259998,2257578.392236973,2257578.392236973,810435.456259998,39.001769122371705,0,85.71428571428571,-190.4427902688809,-484.10573635130277,-293.66294608242185,15.646986967047283,9.678991596638642,14.272654883392072
1542931200,4268.18,4366.05,4085.73,4283.8,19589.9546,14272.17794499998,19589.9546,14272.17794499998,16.38725399866692,830025.4108599981,2265672.386749573,2265672.386749573,830025.4108599981,41.86916648657761,0,78.57142857142857,-181.58074628562724,-520.6388789394559,-339.0581326538287,16.38725399866692,10.593590196671201,13.622481023466776
1543017600,4283.8,4370.78,3650.84,3774.99,22955.35965,15217.16738649998,22955.35965,15217.16738649998,12.997754692373974,807070.0512099981,2250634.09769031,2250634.09769031,807070.0512099981,44.789059077965454,14.285714285714286,100,-195.8873632871552,-583.9173367627727,-388.0299734756175,12.997754692373974,4.543042722532235,8.271874838614014
1543104000,3775,4120,3456.78,3936.69,39065.19715,16965.99256899998,39065.19715,16965.99256899998,18.749435988810035,846135.2483599981,2268104.5260167927,2268104.5260167927,846135.2483599981,47.59483959295501,7.142857142857143,100,-180.72882294735587,-613.9410021598123,-433.2121792124565,18.749435988810035,16.397032947133564,10.511221955445656
1543190400,3936.7,4076.25,3508,3731.32,36455.03474,18513.13730249998,36455.03474,18513.13730249998,17.194654132904134,809680.2136199981,2260302.8598932005,2260302.8598932005,809680.2136199981,50.20020721401674,0,92.85714285714286,-170.91036086625297,-646.8501302952727,-475.93976942901975,17.194654132904134,9.561056473407069,10.167044047690945
1543276800,3731.01,3830,3562.9,3775,23788.7294,19410.92194899998,23788.7294,19410.92194899998,18.73812488827329,833468.943019998,2274294.658428356,2274294.658428356,833468.943019998,52.61947714785978,0,85.71428571428571,-148.6703279319106,-661.777679343908,-513.1073514119973,18.73812488827329,11.218360008460825,12.39214980966714
1543363200,3775.01,4365,3775,4225.03,35951.2384,20941.693568999985,35951.2384,20941.693568999985,32.66422232225041,869420.181419998,2293187.9482220914,2293187.9482220914,869420.181419998,52.12058282543519,0,78.57142857142857,-93.5393968663235,-630.0315974949017,-536.4922006285782,32.66422232225041,34.79046471818929,18.523293733352386
1543449600,4224.86,4414.89,4077.88,4248,20589.29642,21741.750523999985,20589.29642,21741.750523999985,33.29260009700499,890009.4778399981,2293385.281913782,2293385.281913782,890009.4778399981,51.443668614898854,21.428571428571427,71.42857142857143,-47.723918864098664,-596.1470992087015,-548.4231803446029,33.29260009700499,35.83066904565668,27.279831257435585
1543536000,4247.99,4297.71,3869,3976,20007.3628,22621.036411999987,20007.3628,22621.036411999987,29.751950338977537,870002.1150399981,2283365.033105058,2283365.033105058,870002.1150399981,51.16234751998101,14.285714285714286,64.28571428571429,-28.864433266686547,-584.5037219279611,-555.6392886612746,29.751950338977537,23.513055764371295,31.378063176072413
1543622400,3976.01,4277,3910.08,4142.01,10546.31949,23030.179095999985,10546.31949,23030.179095999985,34.34156090899148,880548.4345299981,2286151.363126209,2286151.363126209,880548.4345299981,50.90112078898588,7.142857142857143,57.142857142857146,0.12947592776890815,-555.4774437515634,-555.6069196793323,34.34156090899148,31.030875546820518,30.12486678561615
1543708800,4142.01,4266,4036,4103.19,11311.34187,23409.188935999984,11311.34187,23409.188935999984,33.78568196935282,869237.0926599981,2281448.7956931246,2281448.7956931246,869237.0926599981,50.658553110204686,0,50,20.883469684700685,-529.5025825734565,-550.3860522581572,33.78568196935282,30.734302640712787,28.426077983968188
1543795200,4102.8,4119.98,3741.95,3833.47,17040.76192,24026.88689399999,17040.76192,24026.88689399999,30.135752044073442,852196.3307399981,2272659.0748593793,2272659.0748593793,852196.3307399981,50.91962639084713,0,42.857142857142854,20.601789204793022,-524.6338157521659,-545.2356049569589,30.135752044073442,26.30112692184159,29.355435036458285
1543881600,3833.47,4035.1,3732.43,3901.84,16954.94951,23238.028334499984,16954.94951,23238.028334499984,32.13709445700614,869151.2802499981,2274684.123343823,2274684.123343823,869151.2802499981,51.17674182456835,0,35.714285714285715,28.679280113381537,-509.386504815232,-538.0657849286135,32.13709445700614,38.01429828232701,31.68324261496045
1543968000,3901.84,3912.53,3660,3694.39,14945.1977,22890.640726499987,14945.1977,22890.640726499987,29.386382701749667,854206.0825499981,2263809.454681189,2263809.454681189,854206.0825499981,51.53105138026852,0,28.571428571428573,23.905148368580512,-508.18434946788784,-532.0894978364684,29.386382701749667,20.986204094610564,28.433876432926372
1544054400,3694.39,3849,3400,3433.26,28942.7519,23869.791892999987,28942.7519,23869.791892999987,26.33120029947763,825263.330649998,2239154.6133744805,2239154.6133744805,825263.330649998,52.238808256528365,0,100,7.8459195345024,-522.2820984183404,-530.1280179528428,26.33120029947763,3.277202455438541,20.759234944125357
1544140800,3433.3,3550,3212,3380.01,37833.31094,25522.24102499999,37833.31094,25522.24102499999,25.743433553649297,787430.019709998,2238932.9862867254,2238932.9862867254,787430.019709998,53.132984481103854,42.857142857142854,100,-1.1962046976425427,-531.6232738248959,-530.4270691272534,25.743433553649297,13.967195670427069,12.743534073492045
1544227200,3380,3495,3253.66,3401,13700.5652,25971.034389999986,13700.5652,25971.034389999986,26.44046256429182,801130.584909998,2241961.030323222,2241961.030323222,801130.584909998,53.96329097535252,35.714285714285715,92.85714285714286,-0.6255908612549774,-531.209057703822,-530.5834668425671,26.44046256429182,15.712159881618431,10.985519335828004
1544313600,3401,3642.51,3367.79,3531.18,11757.58731,24479.312135499982,11757.58731,24479.312135499982,30.78019424213784,812888.172219998,2244189.117085593,2244189.117085593,812888.172219998,53.879814272142724,28.571428571428573,85.71428571428571,12.90986500697386,-514.4461355838498,-527.3560005908237,30.78019424213784,26.534429582089782,18.737928378045083
1544400000,3531.18,3590.71,3354.97,3410.15,13514.0223,21825.170930499986,13514.0223,21825.170930499986,29.0634540872896,799374.149919998,2237001.5879603955,2237001.5879603955,799374.149919998,53.825059363567426,21.428571428571427,78.57142857142857,17.80082220575696,-505.10497283362747,-522.9057950393844,29.0634540872896,16.47282793937933,19.573139134362503
1544486400,3410.15,3424.92,3293.49,3349.36,11090.90321,20953.905125499987,11090.90321,20953.905125499987,28.21232414733798,788283.246709998,2235340.0199454455,2235340.0199454455,788283.246709998,53.88702982446387,14.285714285714286,71.42857142857143,20.820987445848687,-496.8795607320735,-517.7005481779222,28.21232414733798,11.419165509730739,18.14214101039994
1544572800,3350.27,3486.16,3325.58,3430.24,10524.1028,20828.199365499986,10524.1028,20828.199365499986,31.103276231275103,798807.349509998,2238534.3453313713,2238534.3453313713,798807.349509998,53.55922562825032,7.142857142857143,64.28571428571429,31.503847668030915,-478.3207385928836,-509.8245862609145,31.103276231275103,18.142972341610598,15.344988596906878
1544659200,3430.24,3439.63,3227.96,3265,14265.0719,20561.955230499985,14265.0719,20561.955230499985,28.571727847502018,784542.277609998,2229261.745327965,2229261.745327965,784542.277609998,53.459408371205086,0,57.142857142857146,30.650916408268188,-471.51094075057927,-502.16185715884745,28.571727847502018,4.881598216835067,11.481245356058793
1544745600,3265,3294.9,3135,3195.71,14656.4789,20147.011192999984,14656.4789,20147.011192999984,27.55879562377224,769885.798709998,2225734.657722762,2225734.657722762,769885.798709998,53.553823884564665,0,100,28.665731803847734,-466.3296924040378,-494.99542420788555,27.55879562377224,5.31611208406305,9.446894214169562
1544832000,3195.71,3228.69,3128.89,3183,9343.274,18660.91503549998,9343.274,18660.91503549998,27.36713500331689,760542.524709998,2226522.9379540244,2226522.9379540244,760542.524709998,53.6539656571383,0,100,29.620407813255156,-457.96991444131663,-487.5903222545718,27.36713500331689,4.758554581350979,4.985421627416355
1544918400,3183.01,3258,3181.24,3195,7211.11386,17198.71899149998,7211.11386,17198.71899149998,27.87713013924835,767753.6385699981,2221897.153086041,2221897.153086041,767753.6385699981,53.530510366547524,0,92.85714285714286,33.87710937883975,-445.2439355310221,-479.12104490986184,27.87713013924835,6.670433563046761,5.581700076153587
1545004800,3194.99,3585.95,3184.28,3496.82,21857.072,17102.136121499978,21857.072,17102.136121499978,39.40214652652863,789610.7105699981,2234054.118892599,2234054.118892599,789610.7105699981,51.346424962329074,0,85.71428571428571,58.39873580496402,-406.1226251536568,-464.52136095862085,39.40214652652863,40.60096445636224,17.343317533586653
1545091200,3497.1,3688,3436.5,3667.77,16980.0505,16153.57672649998,16980.0505,16153.57672649998,44.78408353879691,806590.7610699981,2248302.507988106,2248302.507988106,806590.7610699981,48.79081137497324,0,78.57142857142857,85.8516401639485,-357.2068107536852,-443.0584509176337,44.78408353879691,68.76627022612423,38.67922274851107
1545177600,3667.76,3928.15,3637.17,3682.51,28450.3117,16546.62749049998,28450.3117,16546.62749049998,45.235722906790194,835041.0727699981,2228718.3529482065,2228718.3529482065,835041.0727699981,45.327146617404125,100,71.42857142857143,103.53805561379556,-313.6358814003893,-417.17393701418484,45.235722906790194,69.26657157871033,59.544602087065584
1545264000,3682.51,4175,3661.5,4075.34,30698.03126,17081.16091349998,30698.03126,17081.16091349998,55.64774456356627,865739.1040299981,2247500.645959437,2247500.645959437,865739.1040299981,42.982175373556586,100,64.28571428571429,138.06871024091225,-244.58804921304454,-382.6567594539568,55.64774456356627,90.47327718882337,76.1687063312193
1545350400,4075.33,4162.27,3775,3839.06,23496.8844,17728.68915899998,23496.8844,17728.68915899998,49.54600903712237,842242.2196299981,2231777.2034199685,2231777.2034199685,842242.2196299981,40.80470207569816,92.85714285714286,57.142857142857146,140.8838366790477,-206.5519636051472,-347.4358002841949,49.54600903712237,67.88674231199396,75.87553035984254
1545436800,3839.26,4005,3790.16,3980.46,9902.78213,17658.261171999977,9902.78213,17658.261171999977,52.87608619653204,852145.001759998,2239417.7040989334,2239417.7040989334,852145.001759998,38.78276258482962,85.71428571428571,50,147.45426340954572,-163.11797102226274,-310.57223443180845,52.87608619653204,81.40348529313361,79.9211682646503
1545523200,3981.24,4050,3903.6,3944.93,10282.42448,17320.344299999975,10282.42448,17320.344299999975,51.94827337439575,841862.577279998,2234940.9162822994,2234940.9162822994,841862.577279998,37.0816887013239,78.57142857142857,42.857142857142854,144.40666963221133,-130.0638973915443,-274.4705670237556,51.94827337439575,78.00709294433663,75.76577351648807
1545609600,3944.92,4239.37,3944.92,4034,19713.69712,17458.28168049998,19713.69712,17458.28168049998,54.12162512883495,861576.274399998,2227155.1942986525,2227155.1942986525,861576.274399998,36.19103088160633,100,35.714285714285715,143.1129957354302,-95.57932235446788,-238.69231808989807,54.12162512883495,81.50619551905484,80.30559125217502
1545696000,4034,4045.41,3675.86,3780,13871.74963,17404.609276999974,13871.74963,17404.609276999974,47.520886904663406,847704.524769998,2221101.623569847,2221101.623569847,847704.524769998,34.047672916717474,92.85714285714286,28.571428571428573,120.76635197207912,-87.73437812479915,-208.50073009687827,47.520886904663406,58.633203659678706,72.71549737435672
1545782400,3780,3849.2,3685.02,3809.88,9374.88635,16426.215999499975,9374.88635,16426.215999499975,48.319397727475824,857079.4111199981,2225986.0661230143,2225986.0661230143,857079.4111199981,32.05741194932069,85.71428571428571,21.428571428571427,104.23687001221191,-78.20464258161337,-182.44151259382528,48.319397727475824,61.32393199337226,67.15444372403526
1545868800,3809.88,3841.21,3567,3589.89,13433.24226,15206.212565499978,13433.24226,15206.212565499978,43.117573614543666,843646.1688599981,2214795.5350357024,2214795.5350357024,843646.1688599981,29.856560548476267,78.57142857142857,14.285714285714286,76.03627856179804,-87.39616439157771,-163.43244295337576,43.117573614543666,41.51357971327714,53.82357178877603
1545955200,3589.89,3971.58,3576.12,3888.06,16776.57029,15360.012819999978,16776.57029,15360.012819999978,50.842119995310306,860422.7391499981,2224485.779777628,2224485.779777628,860422.7391499981,28.190675472586364,71.42857142857143,7.142857142857143,74.89324201713347,-69.8158904319589,-144.70913244909238,50.842119995310306,68.36413082630935,57.06721417765291
1546041600,3887.58,3944.33,3706,3729.31,9776.58796,15260.962852499977,9776.58796,15260.962852499977,47.16938527853033,850646.151189998,2216621.601210886,2216621.601210886,850646.151189998,26.643782187831448,64.28571428571429,0,61.43901276042587,-67.91036649856005,-129.34937925898592,47.16938527853033,51.79609310765219,53.891267882412876
1546128000,3729.31,3863.06,3691.01,3829,8725.69621,15021.546547999978,8725.69621,15021.546547999978,49.63009068397125,859371.847399998,2221892.520171103,2221892.520171103,859371.847399998,25.130200020913556,57.142857142857146,0,57.32666444806475,-57.69104869890498,-115.01771314696973,49.63009068397125,61.10568766645499,60.42197053347217
1546214400,3829,3835.4,3625,3691.86,12795.32337,15106.767555999977,12795.32337,15106.767555999977,46.42649921344941,846576.524029998,2217229.2815969037,2217229.2815969037,846576.524029998,23.379050588307983,50,0,44.04060583697189,-59.96695585075486,-104.00756168772675,46.42649921344941,31.80589634685568,48.23589237365428
1546300800,3691.87,3841.17,3651.02,3826.1,10812.89471,15121.207151499979,10812.89471,15121.207151499979,49.83964723948062,857389.418739998,2226328.2628356474,2226328.2628356474,857389.418739998,21.78351955835044,42.857142857142854,0,42.91958063913711,-50.35808588880536,-93.27766652794247,49.83964723948062,38.535330249713695,43.81563808767478
1546387200,3826.1,3916.57,3770.07,3890.79,9982.33799,14907.070455999981,9982.33799,14907.070455999981,51.44503029861905,867371.756729998,2232797.3629637742,2232797.3629637742,867371.756729998,20.70541445063546,35.714285714285715,57.142857142857146,44.945787777614854,-37.09543180592391,-82.04121958353876,51.44503029861905,48.15652096316017,39.4992491865765
1546473600,3890.8,3893.8,3758.07,3787.57,9327.6912,14640.631070999982,9327.6912,14640.631070999982,48.76325627633514,858044.065529998,2227524.293297702,2227524.293297702,858044.065529998,19.63048602474755,28.571428571428573,50,38.02033757255592,-34.51579761784387,-72.53613519039979,48.76325627633514,32.8048544700091,39.83223522762764
1546560000,3787.57,3849,3730,3820.25,9225.0275,14634.718745999984,9225.0275,14634.718745999984,49.65802719289819,867269.093029998,2232291.8495266936,2232291.8495266936,867269.093029998,18.452540703870643,21.428571428571427,42.857142857142854,34.43336998327211,-29.494422711309653,-63.92779269458176,49.65802719289819,37.66527358448474,39.54221633921799
1546646400,3820.82,3874.12,3775,3798.62,6451.0077,14596.713437999986,6451.0077,14596.713437999986,49.04749811572334,860818.085329998,2228915.3535674927,2228915.3535674927,860818.085329998,17.514022624596137,14.285714285714286,35.714285714285715,29.582515451329,-26.949648380420513,-56.532163831749514,49.04749811572334,34.448294837663774,34.97280763071919
1546732800,3799.99,4088,3756.01,4040.99,10057.3227,14006.725972999988,10057.3227,14006.725972999988,55.63029504894735,870875.4080299981,2236124.429391822,2236124.429391822,870875.4080299981,17.79689384778474,7.142857142857143,28.571428571428573,40.97420959072982,-5.314401843337237,-46.28861143406706,55.63029504894735,70.4954117524577,47.53632672486872
1546819200,4040.98,4070,3968.79,4006.01,9973.5444,13656.400667999987,9973.5444,13656.400667999987,54.53521071617798,860901.863629998,2233486.43133246,2233486.43133246,860901.863629998,18.059559983602732,0,21.428571428571427,44.15602956448408,8.90642552153804,-35.24960404294604,54.53521071617798,84.26295585412672,63.06888748141605
1546905600,4005.97,4114.8,3943.36,3993.86,13959.45482,12931.857823999988,13959.45482,12931.857823999988,54.13658235542634,846942.4088099981,2227750.8737174296,2227750.8737174296,846942.4088099981,18.526767582102618,100,14.285714285714286,43.381579943904995,18.977370886935205,-24.40420905696979,54.13658235542634,77.92259948886455,77.56032236514964
1546992000,3993.85,4042.2,3962.12,4004.12,10704.1816,11932.165340999989,10704.1816,11932.165340999989,54.43943825255939,857646.5904099981,2228274.854634912,2228274.854634912,857646.5904099981,18.96060320928109,92.85714285714286,7.142857142857143,41.499293566375606,27.469907900999715,-14.029385665375889,54.43943825255939,79.79554581964216,80.66036705421112
1547078400,4004.13,4035.21,3560,3626.12,21869.2784,11850.78504099999,21869.2784,11850.78504099999,43.13748381754277,835777.3120099981,2212491.2928141425,2212491.2928141425,835777.3120099981,18.456849577469743,85.71428571428571,100,14.148877695866558,3.6567114544573087,-10.49216624140925,43.13748381754277,11.917808219178058,56.54531784256158
1547164800,3626.12,3699.99,3576,3635.69,14489.51147,12080.12150799999,14489.51147,12080.12150799999,43.45753502931168,850266.8234799982,2211952.566724323,2211952.566724323,850266.8234799982,17.989078347930636,78.57142857142857,92.85714285714286,-3.0291505353112154,-14.278604410548269,-11.249453875237053,43.45753502931168,13.642754145638072,35.11870272815275
1547251200,3634.73,3649.18,3557.29,3619.41,5793.62414,11855.68149099999,5793.62414,11855.68149099999,43.01399751906041,844473.1993399982,2213992.22001553,2213992.22001553,844473.1993399982,17.652658706004345,71.42857142857143,100,-14.57360520371154,-29.46646037987648,-14.89285517616494,43.01399751906041,11.142401033165301,12.234321132660455
1547337600,3619.38,3641.86,3481.54,3514.24,8288.75879,11284.43457449999,8288.75879,11284.43457449999,40.16228442621083,836184.4405499982,2209084.728845702,2209084.728845702,836184.4405499982,17.733929395468582,64.28571428571429,100,-27.62140165595131,-49.41960724610408,-21.79820559015277,40.16228442621083,5.16375580330351,9.982970327368944
1547424000,3514.24,3711.11,3509.24,3664.19,11241.37747,11152.91596649999,11241.37747,11152.91596649999,45.69080198198149,847425.8180199981,2215100.511319988,2215100.511319988,847425.8180199981,17.309768759099203,57.142857142857146,92.85714285714286,-24.5833594084719,-52.52740485074264,-27.944045442270742,45.69080198198149,28.842813378391185,15.049656738286648
1547510400,3664.18,3684.38,3538.63,3580.76,10894.6812,11228.90570899999,10894.6812,11228.90570899999,43.29405384880638,836531.1368199982,2210504.189213724,2210504.189213724,836531.1368199982,16.915905311041925,50,85.71428571428571,-26.46002022620224,-61.01907072502354,-34.5590504988213,43.29405384880638,15.66812999399934,16.55823305856466
1547596800,3580.19,3666.73,3572.52,3609.71,8894.6755,11001.97737099999,8894.6755,11001.97737099999,44.3842445303141,845425.8123199982,2208631.9737889813,2208631.9737889813,845425.8123199982,16.550174966417313,42.857142857142854,78.57142857142857,-24.086607252249095,-64.66730956413267,-40.58070231188357,44.3842445303141,20.239711966648773,21.58355177967975
1547683200,3609.71,3657,3541,3640.65,8924.73781,10609.38574699999,8924.73781,10609.38574699999,45.588235145246536,854350.5501299981,2215040.8587853005,2215040.8587853005,854350.5501299981,16.414635968947806,35.714285714285715,71.42857142857143,-18.991853192108906,-64.3205188020197,-45.3286656099108,45.588235145246536,25.125540852098677,20.344460937582244
1547769600,3640.64,3643.69,3580.16,3607.85,5977.38338,10419.425517999991,5977.38338,10419.425517999991,44.488689923733524,848373.1667499981,2214274.0450823726,2214274.0450823726,848373.1667499981,16.288778328440415,28.571428571428573,64.28571428571429,-16.48294230345563,-65.93234348923033,-49.449401185774704,44.488689923733524,19.945993746644334,21.770415521797247
1547856000,3607.85,3765.9,3604.9,3682.65,6068.546,10286.568007499991,6068.546,10286.568007499991,47.59297947394177,854441.7127499981,2214066.734504733,2214066.734504733,854441.7127499981,15.13077441943583,21.428571428571427,57.142857142857146,-8.821960486698217,-60.47685179414748,-51.65489130744926,47.59297947394177,31.757887755424324,25.6098074513891
1547942400,3683.5,3703.39,3481.01,3536.19,7429.72012,10018.287844999992,7429.72012,10018.287844999992,42.57284309471755,847011.9926299981,2210324.144128609,2210324.144128609,847011.9926299981,14.925365948809999,14.285714285714286,100,-12.433551014260672,-67.1968300752751,-54.76327906101443,42.57284309471755,8.706353839599842,20.136745113889482
1548028800,3537.56,3568.95,3487.37,3531.76,6493.90781,9802.338499999993,6493.90781,9802.338499999993,42.42706743492333,840518.0848199981,2210897.27646781,2210897.27646781,840518.0848199981,14.734629511800298,7.142857142857143,92.85714285714286,-13.828884588067147,-72.04938479609837,-58.22050020803122,42.42706743492333,8.00738414932391,16.157208581449343
1548115200,3531.75,3611.5,3425,3577.03,9658.60166,9786.151683499993,9658.60166,9786.151683499993,44.51779537448789,850176.6864799982,2216985.561782285,2216985.561782285,850176.6864799982,14.973878183055126,0,100,-10.5587088306632,-71.41888624636022,-60.86017741569702,44.51779537448789,24.632209980557395,13.781982656493696
1548201600,3577.04,3614.47,3523.64,3553.01,8204.0133,9729.967788499993,8204.0133,9729.967788499993,43.612812302141016,841972.6731799982,2214087.105470527,2214087.105470527,841972.6731799982,15.167400641599754,0,92.85714285714286,-8.9335707199984,-72.02714081569502,-63.09357009569662,43.612812302141016,20.978023958964982,17.872539362948743
1548288000,3553.01,3595.83,3530.1,3568.97,5826.99443,9560.066134999992,5826.99443,9560.066134999992,44.42127494009611,847799.6676099981,2215151.797439252,2215151.797439252,847799.6676099981,15.347100067391192,0,85.71428571428571,-5.852911147632739,-70.40970903023754,-64.5567978826048,44.42127494009611,42.23232619536514,29.28085337829582
1548374400,3568.97,3578.79,3510.01,3562.17,6833.9701,9579.214254999993,6833.9701,9579.214254999993,44.130950557805754,840965.6975099981,2218683.0463103484,2218683.0463103484,840965.6975099981,15.66651008372302,57.142857142857146,78.57142857142857,-3.460602246603571,-68.88255069085926,-65.42194844425569,44.130950557805754,40.23760633616897,34.48265216349968
1548460800,3562.17,3657.76,3540,3556.07,5602.8378,9356.490009999994,5602.8378,9356.490009999994,43.854060153645726,835362.8597099981,2214609.3797645266,2214609.3797645266,835362.8597099981,15.11617048931059,50,71.42857142857143,-1.5725872192942063,-67.38768246837344,-65.81509524907923,43.854060153645726,38.44822528600766,40.306052605847235
1548547200,3556.07,3562.9,3470.14,3531.02,4286.3925,9072.132414999993,4286.3925,9072.132414999993,42.67006345761577,831076.4672099982,2215949.4550394295,2215949.4550394295,831076.4672099982,15.171532860735864,42.857142857142854,64.28571428571429,-1.305387174735671,-67.44682921749882,-66.14144204276315,42.67006345761577,31.10002933411556,36.59528698543071
1548633600,3531.02,3535.92,3374.01,3429.95,13775.572,9062.938273999991,13775.572,9062.938273999991,38.18995019738532,817300.8952099981,2211692.819456945,2211692.819456945,817300.8952099981,15.90311891692035,35.714285714285715,100,-6.916533190818541,-74.78710853128632,-67.87057534046778,38.18995019738532,14.274413738548985,27.940889452890715
1548720000,3429.95,3438.4,3337.87,3397.42,8709.7285,8963.215618999991,8709.7285,8963.215618999991,36.848924791209534,808591.1667099982,2213301.6890306547,2213301.6890306547,808591.1667099982,16.815950433715923,28.571428571428573,100,-11.528140232805981,-82.28075063147526,-70.75261039866928,36.848924791209534,13.912576221292936,19.762339764652477
1548806400,3395.74,3459.41,3372.97,3437.55,8513.92739,8295.44806849999,8513.92739,8295.44806849999,39.6636544907907,817105.0940999981,2217509.405112339,2217509.405112339,817105.0940999981,17.41809887021345,21.428571428571427,92.85714285714286,-10.608241132173504,-84.01291181388615,-73.40467068171264,39.6636544907907,23.288087283601673,17.15835908114785
1548892800,3437.55,3473.4,3396.74,3411.5,7405.29989,7941.23748949999,7405.29989,7941.23748949999,38.46513136680951,809699.7942099981,2212955.7156156707,2212955.7156156707,809699.7942099981,17.809124672176637,14.285714285714286,85.71428571428571,-10.468798439430913,-86.49066873100128,-76.02187029157037,38.46513136680951,17.202065275798443,18.134242926897674
1548979200,3411.5,3458.26,3369.62,3437.5,8796.5774,8091.38515249999,8796.5774,8091.38515249999,40.400857901393756,818496.371609998,2217631.8745403998,2217631.8745403998,818496.371609998,18.380130651229315,7.142857142857143,78.57142857142857,-7.480270608598971,-85.37220855231908,-77.89193794372011,40.400857901393756,23.27640585940239,21.255519472934157
1549065600,3437.5,3483.25,3414.49,3468.43,3967.9587,7875.34514799999,3967.9587,7875.34514799999,42.70970431716096,822464.330309998,2219889.386819981,2219889.386819981,822464.330309998,18.585890364321372,0,71.42857142857143,-2.5309848439233065,-81.05566899862424,-78.52468415470094,42.70970431716096,35.71897570584372,25.39914894701484
1549152000,3468.43,3471.76,3386.45,3414.78,4606.70527,7543.61153799999,4606.70527,7543.61153799999,39.8275754516557,817857.625039998,2218342.2984834965,2218342.2984834965,817857.625039998,19.01208417998915,0,64.28571428571429,-2.004113109872563,-81.02982554204164,-79.02571243216907,39.8275754516557,24.042639657382296,27.679340407542792
1549238400,3415.69,3435,3395.1,3409.57,6032.753,7300.51512799999,6032.753,7300.51512799999,39.54846943975675,811824.872039998,2216685.1813687095,2216685.1813687095,811824.872039998,19.407835580252083,35.714285714285715,57.142857142857146,-1.1808488862379534,-80.5017735399665,-79.32092465372855,39.54846943975675,22.41395479696152,27.391856720062503
1549324800,3409.57,3429.46,3400,3428.4,6385.3924,7175.05097299999,6385.3924,7175.05097299999,41.15357171553381,818210.264439998,2222611.06827353,2222611.06827353,818210.264439998,19.775319023353383,28.571428571428573,50,1.3218995684579795,-77.66855019315608,-78.99044976161406,41.15357171553381,28.300353246428493,24.918982566924097
1549411200,3428.41,3441,3340.8,3367.36,9813.314,7219.479782499991,9813.314,7219.479782499991,37.662539196317155,808396.950439998,2218000.1818152466,2218000.1818152466,808396.950439998,20.651664418870087,21.428571428571427,42.857142857142854,-0.35401169304995506,-79.43296437792651,-79.07895268487655,37.662539196317155,9.21879396042396,19.97770066793798
1549497600,3366,3383.14,3352.01,3359,8613.80855,7351.30104099999,8613.80855,7351.30104099999,37.19713289089959,799783.141889998,2213254.7010368174,2213254.7010368174,799783.141889998,21.46541371470703,14.285714285714286,35.714285714285715,-1.1984504787710364,-80.57701578334036,-79.37856530456932,37.19713289089959,6.605395604739156,14.708180937197193
1549584000,3358.99,3711,3344,3621.99,17649.55367,7930.35142449999,17649.55367,7930.35142449999,55.730217111566446,817432.695559998,2222343.018891195,2222343.018891195,817432.695559998,21.316141626974964,100,28.571428571428573,15.842183039534959,-59.57583650515062,-75.41801954468558,55.730217111566446,76.14504328250203,30.65641094922171
1549670400,3622,3644.08,3597,3623.73,5155.56165,7816.643500999989,5155.56165,7816.643500999989,55.82310479139158,822588.2572099981,2223041.6697689984,2223041.6697689984,822588.2572099981,21.17753183122376,92.85714285714286,21.428571428571427,26.49106300717861,-42.30419078571231,-68.79525379289092,55.82310479139158,76.61136869187685,53.12060252637267
1549756800,3623.73,3654.28,3578.59,3648.84,5364.09361,7760.152790999989,5364.09361,7760.152790999989,57.21816290870473,827952.3508199981,2227634.705927858,2227634.705927858,827952.3508199981,20.8379323183342,85.71428571428571,14.285714285714286,34.00652410600126,-26.287098660389347,-60.293622766390605,57.21816290870473,83.3409267547504,78.69911290970975
1549843200,3648.85,3652,3579.38,3590.36,8819.23577,7718.184496499989,8819.23577,7718.184496499989,53.01889917427154,819133.115049998,2221482.372078943,2221482.372078943,819133.115049998,20.522589913508178,78.57142857142857,7.142857142857143,33.75201980697874,-18.103598007667188,-51.855617814645925,53.01889917427154,67.66810495001747,75.87346679888157
1549929600,3590.36,3618.77,3550,3588.06,8347.13429,7725.340545999989,8347.13429,7725.340545999989,52.85460309005048,810785.9807599981,2222374.497090307,2222374.497090307,810785.9807599981,19.86576531851704,71.42857142857143,0,32.149141934538406,-11.669190396472914,-43.81833233101132,52.85460309005048,66.79092382495945,72.59998517657577
1550016000,3588.06,3627.99,3562.98,3576.68,7025.0331,7785.24247949999,7025.0331,7785.24247949999,51.99605230860956,803760.9476599981,2218310.330117672,2218310.330117672,803760.9476599981,19.348187748923,64.28571428571429,50,29.132416350284245,-7.402811893156013,-36.53522824344026,51.99605230860956,63.71690977849804,66.05864618449165
1550102400,3576.69,3589,3535.1,3561.5,6197.4146,7753.414704499989,6197.4146,7753.414704499989,50.81041966837799,797563.5330599981,2218183.8522686926,2218183.8522686926,797563.5330599981,18.50301500016669,57.142857142857146,42.857142857142854,25.078754358825382,-5.186785294908532,-30.265539653733914,50.81041966837799,59.6164235548352,63.374752386097555
1550188800,3561.49,3620.22,3545.89,3566.59,7446.9366,7845.619644499988,7446.9366,7845.619644499988,51.212138555381195,805010.4696599981,2214884.6780155245,2214884.6780155245,805010.4696599981,18.060540681161225,50,35.714285714285715,21.824084867567617,-2.9854335692743916,-24.80951843684201,51.212138555381195,60.991356023770955,61.441563119034726
1550275200,3566.59,3607.36,3565.5,3582.37,4351.58939,7848.879488999989,4351.58939,7848.879488999989,52.50708515128045,809362.0590499981,2214040.5569967283,2214040.5569967283,809362.0590499981,17.649671670656144,42.857142857142854,28.571428571428573,19.873292871436817,0.03209765245401286,-19.841195218982804,52.50708515128045,65.25391680172875,61.95389879344496
1550361600,3582.37,3675,3557.43,3625.08,6402.12696,7480.207236999988,6402.12696,7480.207236999988,55.91754619803425,815764.1860099981,2215006.0219197595,2215006.0219197595,815764.1860099981,17.98978116628962,35.714285714285715,21.428571428571427,20.51532420111629,5.802960032412557,-14.712364168703733,55.91754619803425,76.79092382495945,67.67873221681971
1550448000,3625.08,3917,3616.18,3867,16895.18208,7889.4799159999875,16895.18208,7889.4799159999875,69.34540438045386,832659.3680899981,2226284.8280673083,2226284.8280673083,832659.3680899981,20.009388416201904,100,14.285714285714286,35.41518885230925,29.556621896682827,-5.85856695562642,69.34540438045386,91.32245748004165,77.78909936890994
1550534400,3867,3969.54,3841.54,3888.01,14845.2566,8206.046376499988,14845.2566,8206.046376499988,70.19453756009396,847504.6246899981,2222218.6195017146,2222218.6195017146,847504.6246899981,22.14212931066051,100,7.142857142857143,44.291833190309255,49.50622453226015,5.214391341950895,70.19453756009396,87.03279575023065,85.04872568507724
1550620800,3888.37,3967.19,3867.13,3938.99,8929.2067,8282.241716999988,8929.2067,8282.241716999988,72.2063360764757,856433.8313899981,2226114.7734545628,2226114.7734545628,856433.8313899981,24.122531569800646,92.85714285714286,0,50.739576698468944,68.63886221503708,17.899285516568135,72.2063360764757,95.11621958627742,91.15715760551656
1550707200,3939,3988,3869.45,3897.71,8806.91795,8282.758744499988,8806.91795,8282.758744499988,68.19258605928361,847626.913439998,2221506.649283846,2221506.649283846,847626.913439998,26.068486216586972,100,7.142857142857143,49.32346743035035,79.55361980450607,30.230152374155722,68.19258605928361,85.97981366459628,89.37627633370145
1550793600,3897.71,3956.43,3886.15,3942.02,7667.23336,8467.722477499989,7667.23336,8467.722477499989,70.11303835225975,855294.146799998,2226029.7496695262,2226029.7496695262,855294.146799998,27.875444102888565,92.85714285714286,0,48.40241806481792,90.73317495517813,42.330756890360206,70.11303835225975,89.84764848752484,90.31456057946617
1550880000,3942.02,4156.1,3911.3,4110,10844.9787,8779.636148999989,10844.9787,8779.636148999989,76.02328225154685,866139.125499998,2232790.1408035946,2232790.1408035946,866139.125499998,30.420248953807366,100,35.714285714285715,55.621957167784004,111.8582033500902,56.2362461823062,76.02328225154685,92.57648953301121,89.4679838950441
1550966400,4110,4188.79,3712.84,3734.22,17001.33046,9328.06502199999,17001.33046,9328.06502199999,51.49185014779193,849137.795039998,2217316.233162104,2217316.233162104,849137.795039998,30.32128579859174,100,28.571428571428573,32.737132674854834,97.15766202587474,64.42052935101991,51.49185014779193,30.460921843687355,70.9616866214078
1551052800,3734.23,3860,3731.09,3818.79,11160.93028,9566.841915999988,11160.93028,9566.841915999988,55.01034034911183,860298.725319998,2221341.302192569,2221341.302192569,860298.725319998,30.229391440177235,92.85714285714286,21.428571428571427,21.48698360481214,91.27925885703507,69.79227525222294,55.01034034911183,43.39824687543026,55.4785527507096
1551139200,3818.78,3826.37,3763.71,3799.48,6520.28654,9402.190542999988,6520.28654,9402.190542999988,54.04638064972213,853778.438779998,2222265.338970022,2222265.338970022,853778.438779998,30.144060964506625,85.71428571428571,14.285714285714286,11.440622993572632,84.09305399418872,72.65243100061609,54.04638064972213,40.44424727317231,38.10113866409664
1551225600,3799.49,3823.13,3655,3799.91,8282.0968,9385.604955499988,8282.0968,9385.604955499988,54.06568355452176,862060.535579998,2228259.797779229,2228259.797779229,862060.535579998,28.90308744367912,78.57142857142857,7.142857142857143,3.9091056808764364,77.53881310171164,73.6297074208352,54.06568355452176,40.51002768896571,41.450840612522754
1551312000,3800.35,3910,3754.37,3792.14,9852.6105,8995.75779699999,9852.6105,8995.75779699999,53.62732816268945,852207.9250799981,2223189.4670271566,2223189.4670271566,852207.9250799981,28.360468373085705,71.42857142857143,0,-2.183556476012484,70.9002618258196,73.08381830183208,53.62732816268945,38.30300202208741,39.75242566140847
1551398400,3792.14,3843,3791.31,3806.17,6816.73439,9078.81643399999,6816.73439,9078.81643399999,54.347099201631536,859024.6594699981,2220292.1241262415,2220292.1241262415,859024.6594699981,27.85660780753468,64.28571428571429,0,-5.658782840465079,66.01033975125074,71.66912259171582,54.347099201631536,39.397491130258516,39.40350694710387
1551484800,3806.17,3818.08,3763,3809.7,3720.68922,8996.64621449999,3720.68922,8996.64621449999,54.53829558835185,862745.348689998,2222880.664629335,2222880.664629335,862745.348689998,27.07969872675405,57.142857142857146,7.142857142857143,-7.968462009149988,61.70854508027833,69.67700708942832,54.53829558835185,39.95660162189558,39.21903159141383
1551571200,3809.7,3815.48,3763.62,3786.93,4100.66366,8760.717608999988,4100.66366,8760.717608999988,52.99648378113295,858644.6850299981,2222466.3283860185,2222466.3283860185,858644.6850299981,26.35828315174346,50,0,-11.086764398974793,55.81855159070983,66.90531598968462,52.99648378113295,29.819597981173917,36.39123024444267
1551657600,3786.93,3804.99,3672.39,3700.72,8335.77813,8760.149800999989,8335.77813,8760.149800999989,47.51905319609479,850308.9068999981,2217692.4295082493,2217692.4295082493,850308.9068999981,24.705602011458417,42.857142857142854,0,-18.57175320805529,43.69062447961551,62.2623776876708,47.51905319609479,8.56516607654692,26.113788559872134
1551744000,3700.02,3876.65,3692.36,3844.59,9530.32263,8885.41427749999,9530.32263,8885.41427749999,55.7402662875155,859839.229529998,2223906.8680043537,2223906.8680043537,859839.229529998,23.79652304037513,35.714285714285715,57.142857142857146,-13.675824112813295,45.16759754665418,58.843421659467474,55.7402662875155,35.5177129582795,24.634159005333444
1551830400,3844.59,3894.7,3812,3851.89,6911.10212,8921.09865349999,6911.10212,8921.09865349999,56.115912158230174,866750.3316499981,2223662.8484373596,2223662.8484373596,866750.3316499981,23.10301271613464,28.571428571428573,50,-9.960836604782976,46.392375903488755,56.35321250827173,56.115912158230174,36.88529196875173,26.98939033452605
1551916800,3851.89,3891,3830.79,3857.05,7308.0864,8914.156143499991,7308.0864,8914.156143499991,56.397615235010356,874058.4180499981,2222729.462215536,2222729.462215536,874058.4180499981,22.45903884362561,21.428571428571427,42.857142857142854,-7.294653227950548,47.23489597333355,54.5295492012841,56.397615235010356,37.85196425560618,36.75165639421247
1552003200,3857.04,3910.88,3771,3843.12,8988.40858,9145.99710299999,8988.40858,9145.99710299999,55.36437568912372,865070.0094699981,2223009.6270811977,2223009.6270811977,865070.0094699981,21.17422464551128,14.285714285714286,35.714285714285715,-6.627258912128937,46.24547556112293,52.87273447325187,55.36437568912372,35.24232376028024,36.65985999487938
1552089600,3842.62,3947.33,3834.59,3917,5821.05503,9116.943506499989,5821.05503,9116.943506499989,59.5926319156513,870891.0644999981,2225698.6509055938,2225698.6509055938,870891.0644999981,20.338960130952636,7.142857142857143,28.571428571428573,-1.6287188461762625,50.83683591553154,52.4655547617078,59.5926319156513,49.08297270462167,40.72575357350269
1552176000,3917,3917,3867.84,3900.93,3602.23541,8452.29617299999,3602.23541,8452.29617299999,58.29898909965133,867288.8290899982,2226945.804011334,2226945.804011334,867288.8290899982,19.56335736743389,0,21.428571428571427,0.08578105707695727,52.572781083054,52.48700002597704,58.29898909965133,84.12752710977317,56.15094119155836
1552262400,3900.93,3911.83,3817.01,3849.68,6169.55341,8018.5110134999895,6169.55341,8018.5110134999895,54.25400954890343,861119.2756799981,2225027.659795696,2225027.659795696,861119.2756799981,18.23184809490517,85.71428571428571,14.285714285714286,-2.5932696347110067,49.24541298258828,51.838682617299284,54.25400954890343,66.59597030752913,66.60215670730798
1552348800,3849.67,3875.33,3796.71,3860,6920.72219,7918.086787999989,6920.72219,7918.086787999989,54.93210847636178,868039.9978699981,2229249.458781099,2229249.458781099,868039.9978699981,17.098181239312083,78.57142857142857,7.142857142857143,-3.950508310751445,46.90054722885998,50.85105553961142,54.93210847636178,70.12622720897618,73.61657487542617
1552435200,3860,3871.02,3827.5,3851.02,5689.488,7762.215290499989,5689.488,7762.215290499989,54.1795218215944,862350.5098699981,2229709.6379575697,2229709.6379575697,862350.5098699981,16.04549058768993,71.42857142857143,0,-5.630789033081193,43.81256924825993,49.443358281341126,54.1795218215944,64.97053902669676,67.23091218106735
1552521600,3851.02,3900,3779.28,3853.95,7895.36738,7773.621991499989,7895.36738,7773.621991499989,54.399044882736774,870245.877249998,2231581.452192291,2231581.452192291,870245.877249998,15.6415497370227,64.28571428571429,28.571428571428573,-6.652561076397873,41.12765693584379,47.78021801224166,54.399044882736774,66.03622608569138,67.0443307737881
1552608000,3853.95,3910,3846.79,3902.8,6794.26959,7571.08653599999,6794.26959,7571.08653599999,58.01096439529344,877040.1468399981,2236827.9052643985,2236827.9052643985,877040.1468399981,15.124249975137838,57.142857142857146,21.428571428571427,-4.2623600033584665,42.452268008043575,46.71462801140204,58.01096439529344,83.80373899759957,71.6035013699959
1552694400,3902.8,4037.47,3900.89,3990,6801.91188,7061.11560699999,6801.91188,7061.11560699999,63.559574013297265,883842.0587199981,2238901.646739601,2238901.646739601,883842.0587199981,14.980567497515935,100,14.285714285714286,2.598223616282496,49.96240753175516,47.364183915472665,63.559574013297265,86.99737043935582,78.94577850754892
1552780800,3990,3991,3936.3,3967.01,3579.77959,6682.058072499989,3579.77959,6682.058072499989,61.2610967718434,880262.2791299981,2239341.4295338388,2239341.4295338388,880262.2791299981,14.847148054009882,92.85714285714286,7.142857142857143,4.863123027256599,53.44308769954341,48.57996467228681,61.2610967718434,80.70012052152964,83.83374331949501
1552867200,3967.01,4015.7,3937.69,3970.5,5613.60564,6636.724027499989,5613.60564,6636.724027499989,61.488773019279215,885875.884769998,2238449.844174531,2238449.844174531,885875.884769998,14.988226061738194,85.71428571428571,0,5.807614536548392,55.8394828429723,50.03186830642391,61.488773019279215,80.59459302830984,82.76402799639844
1552953600,3969.68,4009.61,3952.08,4000.85,5889.026,6517.070487499988,5889.026,6517.070487499988,63.497894827611546,891764.910769998,2242545.4452567487,2242545.4452567487,891764.910769998,15.119227068914483,78.57142857142857,0,7.575893869857012,59.50173564374518,51.925841773888166,63.497894827611546,86.25736480654487,82.51735945212812
1553040000,4000.85,4044.82,3965.43,4031.85,7321.29752,6390.504838499988,7321.29752,6390.504838499988,65.47892420261333,899086.208289998,2247474.5717518236,2247474.5717518236,899086.208289998,15.632577931044517,100,14.285714285714286,9.792025814147713,64.1658740415728,54.37384822742509,65.47892420261333,95.2633116645971,87.37175649981727
1553126400,4032.68,4056.33,3915.14,3972.76,9361.953,6517.765768999989,9361.953,6517.765768999989,58.915376578353346,889724.255289998,2245753.8926644237,2245753.8926644237,889724.255289998,15.304895131855229,100,7.142857142857143,6.401038459263994,62.37514630150508,55.97410784224109,58.915376578353346,70.71110643815942,84.07726096976712
1553212800,3972.76,3998.01,3961.7,3983.78,5137.19556,6588.5910859999885,5137.19556,6588.5910859999885,59.72617386025818,894861.450849998,2246864.522935589,2246864.522935589,894861.450849998,15.000618246893746,92.85714285714286,0,4.133045664904884,61.14041492337219,57.00736925846731,59.72617386025818,73.81339108464184,79.9292697291328
1553299200,3983.77,3997.01,3960.25,3983.43,4145.22744,6590.819274999989,4145.22744,6590.819274999989,59.68588585633394,890716.223409998,2247947.063289887,2247947.063289887,890716.223409998,14.69372956913391,85.71428571428571,35.714285714285715,1.9527891503171162,59.448355696363706,57.49556654604659,59.68588585633394,73.68706009745527,72.73718587341885
1553385600,3982.45,3982.45,3946,3969.52,2699.61314,6309.011025499988,2699.61314,6309.011025499988,58.01107510626918,888016.610269998,2248731.395337969,2248731.395337969,888016.610269998,14.159968781932086,78.57142857142857,28.571428571428573,-0.928001637496358,56.335564499176144,57.2635661366725,58.01107510626918,68.66630572098897,72.05558563436203
1553472000,3969.52,3976.47,3858,3907.53,6471.88702,6156.089244999988,6471.88702,6156.089244999988,51.12591031307559,881544.723249998,2247671.0481863003,2247671.0481863003,881544.723249998,13.957983966862923,71.42857142857143,21.428571428571427,-7.16309609569101,48.30969601705874,55.47279211274975,51.12591031307559,46.29128316188418,62.88154966010948
1553558400,3907.54,3923.9,3880.64,3921.45,4279.08103,6024.488190499988,4279.08103,6024.488190499988,52.489535407135406,885823.804279998,2251465.4436627403,2251465.4436627403,885823.804279998,13.770426638584416,64.28571428571429,14.285714285714286,-10.313024150969895,42.581511924037386,52.89453607500728,52.489535407135406,51.315646995127146,55.42441195933344
1553644800,3922.41,4035.8,3914.9,4026.53,6852.49391,6001.708565999988,6852.49391,6001.708565999988,61.27349154773357,892676.2981899979,2257267.108481827,2257267.108481827,892676.2981899979,13.594127871613287,57.142857142857146,7.142857142857143,-5.522981539071125,45.99080915116838,51.5137906902395,61.27349154773357,89.2438188052699,62.28358298742709
1553731200,4026.54,4026.54,3994,4011.17,4867.23952,5795.650112999989,4867.23952,5795.650112999989,59.540605662241546,887809.058669998,2257536.347299774,2257536.347299774,887809.058669998,13.430421873711525,50,0,-3.6810325227524245,46.912500036798974,50.5935325595514,59.540605662241546,78.44802901593974,73.00249827211228
1553817600,4011.98,4101.5,4007.78,4091.01,9995.85344,6004.390033499989,9995.85344,6004.390033499989,65.07035564194311,897804.9121099979,2265294.5459684213,2265294.5459684213,897804.9121099979,14.142606007172404,100,0,2.3003819439659026,53.46900998950878,51.168628045542874,65.07035564194311,95.69199178644773,87.79461320255245
1553904000,4091.01,4131.87,4042.51,4094.14,5262.18992,6087.387758999989,5262.18992,6087.387758999989,65.27075207620086,903067.102029998,2266113.082672629,2266113.082672629,903067.102029998,15.111257552282348,100,64.28571428571429,5.662081502835619,58.2462299240874,52.58414842125178,65.27075207620086,86.22339065980208,86.78780382072985
1553990400,4094.14,4103,4077.01,4094.99,3140.82157,5935.951166999989,3140.82157,5935.951166999989,65.32892520227782,906207.923599998,2267317.930346846,2267317.930346846,906207.923599998,16.010719701313008,92.85714285714286,57.142857142857146,7.047159361386129,61.39309762298444,54.34593826159831,65.32892520227782,86.53375689195599,89.48304644606861
1554076800,4095,4149.5,4051.53,4137,7951.3273,5987.481422499989,7951.3273,5987.481422499989,68.16699517022478,914159.250899998,2273240.2366965553,2273240.2366965553,914159.250899998,17.314309365669267,100,50,9.73139410268125,66.51018088994988,56.77878678726863,68.16699517022478,95.71183533447685,89.4896609620783
1554163200,4137.01,5121,4132.02,4901.93,38405.04831,7623.259437999989,38405.04831,7623.259437999989,87.78063379718209,952564.299209998,2294630.999716111,2294630.999716111,952564.299209998,21.676168228663556,100,42.857142857142854,59.20208890004966,130.7813979123307,71.57930901228104,87.78063379718209,82.65479018210613,88.30012746951299
1554249600,4901.92,5345,4787.11,4975.97,39435.03301,9200.242719499987,39435.03301,9200.242719499987,88.51807059672376,991999.332219998,2281895.4964853455,2281895.4964853455,991999.332219998,25.947051544885785,100,35.714285714285715,91.17837559754449,185.55227850921165,94.37390291166716,88.51807059672376,75.18291862811031,84.51651471489778
1554336000,4975.13,5071.34,4778,4906.49,16348.0181,9677.930144999988,16348.0181,9677.930144999988,83.4297424466661,975651.314119998,2279869.1313864295,2279869.1313864295,975651.314119998,29.83228265697095,92.85714285714286,28.571428571428573,101.14633136146706,220.80681711350098,119.66048575203392,83.4297424466661,70.51042367182244,76.11604416067964
1554422400,4907.92,5066.59,4887.34,5040.66,11752.6896,9925.469030999988,11752.6896,9925.469030999988,85.19908539183402,987404.003719998,2288221.5728265634,2288221.5728265634,987404.003719998,33.43999726105004,85.71428571428571,21.428571428571427,109.56328924353389,256.6145973064513,147.0513080629174,85.19908539183402,79.53328850033624,75.07554360008969
1554508800,5040.95,5244.04,4925,5049.22,12091.33166,10351.046634499988,12091.33166,10351.046634499988,85.30688068390766,999495.3353799981,2285545.89574784,2285545.89574784,999495.3353799981,36.96296053902087,78.57142857142857,14.285714285714286,108.3010272098368,282.4275920752134,174.1265648653766,85.30688068390766,80.10894418291865,76.71755211835912
1554595200,5049.18,5270.33,5029.7,5194.79,10156.5633,10578.19451749999,10156.5633,10578.19451749999,87.03602845912587,1009651.8986799981,2289325.6415963,2289325.6415963,1009651.8986799981,40.258012230653584,71.42857142857143,7.142857142857143,109.53500568378698,311.0453219701103,201.51031628632333,87.03602845912587,89.89845326160054,83.18022864828515
1554681600,5194.76,5352.5,5132.28,5285.54,15755.0484,11071.495637499987,15755.0484,11071.495637499987,87.98530002076524,1025406.9470799981,2295499.7432987792,2295499.7432987792,1025406.9470799981,43.39126195171684,100,0,108.5207553919667,337.1612605262817,228.640505134315,87.98530002076524,95.45065427418368,88.48601723956763
1554768000,5286.82,5287,5145,5187.21,9741.0171,11192.481616499988,9741.0171,11192.481616499988,81.05934626935063,1015665.929979998,2291549.8294634414,2291549.8294634414,1015665.929979998,46.300708121275576,92.85714285714286,0,93.83654291378292,345.93618377654366,252.09964086276074,81.05934626935063,88.5023650528659,91.28382419621671
1554854400,5187.21,5488,5164.49,5318.58,16738.99237,11561.333584999988,16738.99237,11561.333584999988,82.98626730289378,1032404.922349998,2290756.6275437726,2290756.6275437726,1032404.922349998,49.1694324744972,100,0,85.79907856741625,359.34848907203104,273.5494105046148,82.98626730289378,88.6599732262383,90.87099751776263
1554940800,5322.02,5342.74,4967.24,5041.3,16505.06513,12129.727063499988,16505.06513,12129.727063499988,67.4001819367736,1015899.857219998,2280762.1622727755,2280762.1622727755,1015899.857219998,50.03869528037327,92.85714285714286,0,56.07436256896597,343.6423637158223,287.5680011468563,67.4001819367736,69.82205347853699,82.3281305858804
1555027200,5040.11,5118.56,4901.99,5078.19,9915.48305,12418.239843999989,9915.48305,12418.239843999989,68.25443907869794,1025815.3402699981,2286981.029441273,2286981.029441273,1025815.3402699981,50.318042212656536,85.71428571428571,0,34.23650674390035,330.3636345767318,296.12712783283143,68.25443907869794,71.64906018028486,76.71036229502006
1555113600,5078.19,5123.28,5036.74,5066.22,4288.9392,12497.706146999988,4288.9392,12497.706146999988,67.63511798430872,1021526.401069998,2285614.1592871705,2285614.1592871705,1021526.401069998,50.58913035745586,78.57142857142857,0,15.29059559100267,315.2403723215848,299.94977673058213,67.63511798430872,70.63774391390005,70.70295252424064
1555200000,5065.02,5191.19,5013.81,5164.27,4408.93745,12394.558668499989,4408.93745,12394.558668499989,70.03370844544826,1025935.338519998,2288684.8557161535,2288684.8557161535,1025935.338519998,51.01198465495178,71.42857142857143,7.142857142857143,6.136844314507357,307.62083212371635,301.483987809209,70.03370844544826,77.46350428480932,73.25010279299809
1555286400,5163.81,5193.01,4945.54,5029.99,10157.63973,12688.486603499989,10157.63973,12688.486603499989,63.13309682743171,1015777.698789998,2285459.8759061317,2285459.8759061317,1015777.698789998,50.80652878768359,64.28571428571429,0,-11.240261033656225,287.4336615171387,298.67392255079494,63.13309682743171,66.22295314090177,71.44140044653706
1555372800,5029.99,5229.97,5016.45,5202.9,8624.24962,12777.074388999989,8624.24962,12777.074388999989,67.56497810787198,1024401.948409998,2291897.3660917613,2291897.3660917613,1024401.948409998,50.72780947816883,57.142857142857146,0,-13.230901847728433,282.1352952411344,295.3661970888628,67.56497810787198,59.84507042253516,67.84384261608209
1555459200,5201.21,5272.32,5173.11,5227,7415.7403,12904.499427999988,7415.7403,12904.499427999988,68.139862763794,1031817.6887099979,2292537.9556933236,2292537.9556933236,1031817.6887099979,50.78398535871129,50,7.142857142857143,-14.939802747392491,276.69144365462216,291.63124640201465,68.139862763794,63.23943661971831,63.10248672771842
1555545600,5227,5318.18,5222.26,5280.49,8226.35817,12816.024664499988,8226.35817,12816.024664499988,69.43475790271003,1040044.046879998,2294299.5215483257,2294299.5215483257,1040044.046879998,50.975625832296565,42.857142857142854,0,-14.472879145855302,273.5401474696955,288.0130266155508,69.43475790271003,65.45300169813201,62.84583624679518
1555632000,5280.5,5359.47,5196.7,5290.36,6348.2877,12870.329553499987,6348.2877,12870.329553499987,69.67963637202477,1046392.3345799979,2295257.010416268,2295257.010416268,1046392.3345799979,51.27849139222123,35.714285714285715,0,-15.417407683028216,268.74126701176556,284.1586746947938,69.67963637202477,66.27361307827506,64.98868379870846
1555718400,5290.37,5359.98,5260.24,5319.89,4905.8942,12958.583184999987,4905.8942,12958.583184999987,70.4426276308036,1051298.228779998,2296219.1047671,2296219.1047671,1051298.228779998,51.56132202927807,28.571428571428573,42.857142857142854,-15.90729866830992,264.27455135940636,280.1818500277163,70.4426276308036,71.31277623248758,67.67979700296489
1555804800,5319.9,5349.16,5213.34,5297.64,5748.4356,12848.438599999987,5748.4356,12848.438599999987,69.03303577776025,1045549.7931799979,2297606.4830543036,2297606.4830543036,1045549.7931799979,51.30113101561662,21.428571428571427,35.714285714285715,-19.354773430001273,255.98838324021472,275.343156670216,69.03303577776025,67.5159126977356,68.36743400283275
1555891200,5297.64,5440.84,5250.45,5387.6,12342.7761,11545.324989499986,12342.7761,11545.324989499986,71.51490882224716,1057892.5692799978,2303046.2768593933,2303046.2768593933,1057892.5692799978,51.395434524150296,14.285714285714286,28.571428571428573,-17.270188580442777,253.75542094466255,271.0256095251053,71.51490882224716,82.86718656678221,73.89862516566848
1555977600,5387.6,5650.01,5361.01,5532.75,18208.5383,10484.000253999988,18208.5383,10484.000253999988,74.9968957639681,1076101.1075799977,2306478.8068475733,2306478.8068475733,1076101.1075799977,52.09748621192068,100,21.428571428571427,-8.266034203511765,260.69306677071563,268.9591009742274,74.9968957639681,84.32394855752518,78.23568260734767
1556064000,5532.75,5624.47,5374,5441.9,15137.8098,10423.489838999987,15137.8098,10423.489838999987,69.28790270790438,1060963.2977799978,2299548.4253656953,2299548.4253656953,1060963.2977799978,52.74939135056462,92.85714285714286,14.285714285714286,-10.43896904923264,255.9103896626866,266.34935871191925,69.28790270790438,72.1785513756316,79.78989549997968
1556150400,5440.59,5512.12,4963,5134.81,18152.6762,10743.489168999988,18152.6762,10743.489168999988,54.253954436808854,1042810.6215799978,2292755.0560491523,2292755.0560491523,1042810.6215799978,49.98427508106383,85.71428571428571,7.142857142857143,-33.2797171501756,224.74971227419974,258.02942942437534,54.253954436808854,31.12483623432535,62.542445389160726
1556236800,5134.82,5295.03,5041.14,5159.51,14423.389,10860.092035999987,14423.389,10860.092035999987,55.09786913191738,1057234.010579998,2291780.771432389,2291780.771432389,1057234.010579998,47.41666711652738,78.57142857142857,0,-46.6273865541701,199.7451962316627,246.3725827858328,55.09786913191738,30.37318835436572,44.55885865477424
1556323200,5159.5,5221.24,5117.46,5170.6,4268.7147,10565.699605999987,4268.7147,10565.699605999987,55.49485449328075,1061502.7252799978,2291883.602293345,2291883.602293345,1061502.7252799978,45.032459720886386,71.42857142857143,14.285714285714286,-54.08755641512931,178.76313726692115,232.85069368205046,55.49485449328075,31.94742146578283,31.14848201815799
1556409600,5171.9,5214.5,5101,5155,4913.41626,10023.617998999987,4913.41626,10023.617998999987,54.76142225439347,1056589.3090199977,2291645.507232288,2291645.507232288,1056589.3090199977,42.701025869657684,64.28571428571429,7.142857142857143,-59.04649815631279,159.04257098665948,218.08906914297228,54.76142225439347,29.732990759010313,30.684533526386314
1556496000,5155,5189.54,5072.01,5148.25,7338.22773,9903.478530499988,7338.22773,9903.478530499988,54.4262411877386,1049251.0812899978,2293827.6824995684,2293827.6824995684,1049251.0812899978,40.322275872363825,57.142857142857146,0,-61.478397410562366,141.24107237976932,202.7194697903317,54.4262411877386,26.964673003304164,29.54836174269913
1556582400,5148.25,5285,5126.25,5270.69,7270.8413,9430.070976999988,7270.8413,9430.070976999988,59.29338301830998,1056521.9225899978,2299787.711339688,2299787.711339688,1056521.9225899978,38.67198320278265,50,64.28571428571429,-53.81418552141568,135.4517378885621,189.26592340997777,59.29338301830998,44.78682988602779,33.82816454944745
1556668800,5270.68,5358.39,5265.61,5321.15,7327.0836,8971.171900499989,7327.0836,8971.171900499989,61.13551473932977,1063849.0061899978,2301232.911058162,2301232.911058162,1063849.0061899978,37.53392056323189,42.857142857142854,57.142857142857146,-44.69463944080519,133.39762410897129,178.09226354977648,61.13551473932977,52.13170113972133,41.29440134301779
1556755200,5321.15,5422.99,5306.09,5390.01,7325.941,8841.694797999988,7325.941,8841.694797999988,63.55905247669387,1071174.9471899979,2304425.2415503776,2304425.2415503776,1071174.9471899979,36.80529310448413,35.714285714285715,50,-33.86486662004762,135.76118027471693,169.62604689476456,63.55905247669387,62.15484490764328,53.024458644464154
1556841600,5390,5796.93,5363,5657.4,19740.276,9614.261637999989,19740.276,9614.261637999989,71.0963048995325,1090915.223189998,2311470.5634781537,2311470.5634781537,1090915.223189998,37.5323754033318,100,42.857142857142854,-9.783965718873276,157.39608974617295,167.18005546504622,71.0963048995325,83.26837984003447,65.85164196246639
1556928000,5657.41,5846.88,5512,5770.01,11071.6381,9947.39667049999,11071.6381,9947.39667049999,73.57516576648453,1101986.861289998,2317459.325200066,2317459.325200066,1101986.861289998,38.349322511596725,100,35.714285714285715,11.484726560322486,181.53596366544934,170.05123710512686,73.57516576648453,91.3031180703263,78.90878093933472
1557014400,5770.01,5782.22,5627.35,5715.86,5764.86801,9727.75808449999,5764.86801,9727.75808449999,70.44646398906356,1096221.993279998,2318283.8349593575,2318283.8349593575,1096221.993279998,39.10791625498559,92.85714285714286,28.571428571428573,19.20743132948661,194.0605262669851,174.8530949374985,70.44646398906356,85.17672082183097,86.58273957739728
1557100800,5715.86,5753.66,5564.93,5687.9,9146.027,9753.846953499991,9146.027,9753.846953499991,68.81917102722795,1087075.966279998,2321056.283455463,2321056.283455463,1087075.966279998,39.264584833942884,85.71428571428571,21.428571428571427,19.662543605707157,199.43127444463244,179.76873083892528,68.81917102722795,82.01339548354976,86.16441145856903
1557187200,5687.9,5974.51,5687.9,5748.45,16065.5252,10186.33619849999,16065.5252,10186.33619849999,70.41309550748873,1103141.491479998,2311778.850442477,2311778.850442477,1103141.491479998,40.097577696199494,100,14.285714285714286,21.14229847675864,206.19660393487356,185.05430545811492,70.41309550748873,77.65123429328426,81.61378353288836
1557273600,5748.47,5990,5656.26,5948.41,12720.60439,10411.048509499991,12720.60439,10411.048509499991,74.96454064282442,1115862.095869998,2321329.0231396616,2321329.0231396616,1115862.095869998,40.60506466816216,100,7.142857142857143,32.0353412180491,225.0984819806763,193.0631407626272,74.96454064282442,95.95034079844206,85.20499019175872
1557360000,5947,6171.1,5934.49,6153.09,15697.7402,10878.521134499992,15697.7402,10878.521134499992,78.59443110934575,1131559.8360699979,2334637.039312765,2334637.039312765,1131559.8360699979,41.574175338836454,100,0,48.485623480816685,253.67017011364806,205.18454663283137,78.59443110934575,98.40613827038123,90.66923778736923
1557446400,6153.09,6430,6108.81,6343.14,17600.02658,11513.227753499992,17600.02658,11513.227753499992,81.30489166224936,1149159.862649998,2342717.8510433687,2342717.8510433687,1149159.862649998,43.026995742452684,100,0,66.5125638698104,288.3252514700944,221.81268760028397,81.30489166224936,93.60378206025084,95.9867537096914
1557532800,6342.99,7464.13,6342.98,7219.95,37815.4914,13116.580543499993,37815.4914,13116.580543499993,88.52446530449149,1186975.3540499979,2364061.350845363,2364061.350845363,1186975.3540499979,45.52089408008811,100,14.285714285714286,128.258544240332,382.13586790069894,253.87732366036695,88.52446530449149,89.79231811113154,93.9340794805879
1557619200,7215.02,7581.82,6755,6979.76,41010.9384,14549.988658499995,41010.9384,14549.988658499995,79.47078455740123,1145964.4156499978,2345346.966749284,2345346.966749284,1145964.4156499978,47.913935950504076,100,7.142857142857143,142.59328792061535,432.11893356113615,289.5256456405208,79.47078455740123,76.01172997159149,86.46927671432464
1557705600,6979.24,8195,6864.93,7824.93,47237.8216,16001.452823499994,47237.8216,16001.452823499994,85.20477792699666,1193202.2372499977,2366298.5017034505,2366298.5017034505,1193202.2372499977,50.45939845646442,100,0,195.4002766552975,533.7759914596427,338.3757148043452,85.20477792699666,87.94069246435845,84.58158018236053
1557792000,7822.88,8350,7621.27,7990.92,39542.6804,17221.696353499996,39542.6804,17221.696353499996,86.03005910069373,1232744.9176499976,2366872.0558755416,2366872.0558755416,1232744.9176499976,52.888240007590284,100,0,225.76365598235924,620.5802847822943,394.816628799935,86.03005910069373,88.35815185498592,84.10352476364531
1557878400,7990.92,8308.16,7831.77,8203.32,24942.4214,17561.183613499998,24942.4214,17561.183613499998,87.0272317978685,1257687.3390499977,2380836.2306306665,2380836.2306306665,1257687.3390499977,55.143592876492875,92.85714285714286,0,242.9153339587652,698.4607962483915,455.5454622896263,87.0272317978685,95.18119786721682,90.49334739552042
1557964800,8203.33,8388,7660.74,7878.96,29413.2514,18310.676733499997,29413.2514,18310.676733499997,77.884343076796,1228274.0876499978,2369074.3273606556,2369074.3273606556,1228274.0876499978,56.36426599187187,100,0,216.07863176685976,725.643751998201,509.5651202313412,77.884343076796,83.17223140495868,88.90386037572051
1558051200,7878.95,7940.75,6600,7363.69,47373.71252,20465.926624499996,47373.71252,20465.926624499996,66.01878796776123,1180900.3751299977,2375668.6633424624,2375668.6633424624,1180900.3751299977,53.72189576820712,92.85714285714286,0,150.401772247003,697.567335540095,547.165563293092,66.01878796776123,64.38421418636995,80.91254781951518
1558137600,7363.85,7491.22,7204.42,7262.4,11074.41484,20773.976553499993,11074.41484,20773.976553499993,63.9560874205024,1169825.9602899977,2369071.8954510204,2369071.8954510204,1169825.9602899977,51.26826627480414,85.71428571428571,0,89.89998447990547,659.5405438929738,569.6405594130683,63.9560874205024,60.128512576733826,69.22831938935418
1558224000,7262.39,8315,7252.58,8200,25170.36588,21665.583460999995,25170.36588,21665.583460999995,72.5162248125099,1194996.3261699977,2388793.207141152,2388793.207141152,1194996.3261699977,50.23716824385923,78.57142857142857,7.142857142857143,101.90806763285877,697.0256439541417,595.117576321283,72.5162248125099,93.34058312404582,72.61776996238324
1558310400,8194.34,8199.53,7570.31,7999.54,25402.09711,22572.14625149999,25402.09711,22572.14625149999,68.75648915799908,1169594.2290599977,2398047.802897003,2398047.802897003,1169594.2290599977,49.27972007226754,71.42857142857143,0,85.87384998322034,702.4598888003084,616.586038817088,68.75648915799908,85.7797594207355,79.74961837383842
1558396800,7998.94,8112.99,7805.34,7951.7,14246.44773,22918.11445799999,14246.44773,22918.11445799999,67.85235027245675,1155347.7813299978,2397356.4345738795,2397356.4345738795,1155347.7813299978,48.390661055789536,64.28571428571429,7.142857142857143,62.64792962189142,694.8959508444523,632.2480212225609,67.85235027245675,84.02849465908176,87.7162790679544
1558483200,7951.69,8044.32,7506.12,7626.48,17522.66963,23427.950889499993,17522.66963,23427.950889499993,61.89381561213217,1137825.111699998,2387671.1061429386,2387671.1061429386,1137825.111699998,46.69074036781965,57.142857142857146,0,18.28739955793867,655.1072706699842,636.8198711120456,61.89381561213217,68.96201768079199,79.59009058686979
1558569600,7622.25,7984.9,7467.1,7881.98,14905.964,23186.23528949999,14905.964,23186.23528949999,64.52919961403683,1152731.0756999978,2396651.5320398873,2396651.5320398873,1152731.0756999978,45.001821733013365,50,0,0.024070915505717494,636.8499597564278,636.8258888409221,64.52919961403683,77.7982528880874,76.92958840932042
1558656000,7878.16,8175,7794.73,8001.7,14767.95298,23371.051033499993,14767.95298,23371.051033499993,65.72533981127577,1167499.028679998,2397959.1213233876,2397959.1213233876,1167499.028679998,43.769496978522675,42.857142857142854,0,-9.58986085222,624.838562775647,634.428423627867,65.72533981127577,81.11020919110815,75.95682658666254
1558742400,8001.69,8149,7941.25,8063.81,5373.28011,23351.471638499992,5373.28011,23351.471638499992,66.35914763049678,1172872.3087899978,2398925.665139083,2398925.665139083,1172872.3087899978,42.625195420781324,35.714285714285715,0,-16.933218415832243,613.2619006080768,630.195119023909,66.35914763049678,81.86856823266221,80.25901010395262
1558828800,8063.68,8793.97,7881.7,8731.72,19430.8221,23865.71139349999,19430.8221,23865.71139349999,72.29275583821041,1192303.1308899978,2415704.709419523,2415704.709419523,1192303.1308899978,42.56314903010846,100,35.714285714285715,16.230861851916984,650.4836963388052,634.2528344868882,72.29275583821041,97.1626777029768,86.71381837558242
1558915200,8732.34,8947.88,8611.44,8772.29,18163.73667,23970.621966999992,18163.73667,23970.621966999992,72.60879058134007,1210466.8675599978,2414908.92568835,2414908.92568835,1210466.8675599978,42.702970657951425,100,28.571428571428573,32.97333686750619,675.4695055712709,642.4961687037647,72.60879058134007,92.52133839889609,90.51752811151174
1559001600,8772.29,8822.46,8545,8715.36,11990.49285,23934.116389999992,11990.49285,23934.116389999992,71.37843852356738,1198476.3747099978,2417642.720028763,2417642.720028763,1198476.3747099978,42.60997206363656,92.85714285714286,21.428571428571427,32.2480245176929,682.8061993508809,650.558174833188,71.37843852356738,90.09659778182876,93.26020462790058
1559088000,8715.36,8760.43,8426.09,8662.44,12327.61977,23765.61036849999,12327.61977,23765.61036849999,70.18783981174235,1186148.7549399978,2422744.2617867854,2422744.2617867854,1186148.7549399978,42.120182558048654,85.71428571428571,14.285714285714286,20.794672587348714,676.5515155673738,655.7568429800251,70.18783981174235,87.84264953915878,90.15352857329458
1559174400,8662.44,9090,7972,8279.69,31707.61081,24470.98957999999,31707.61081,24470.98957999999,62.11749079834275,1154441.1441299978,2408489.4502077852,2408489.4502077852,1154441.1441299978,40.297259494300455,100,7.142857142857143,-17.878778403587944,633.4083699755402,651.2871483791281,62.11749079834275,67.45742971887553,81.79889234662106
1559260800,8279.69,8580,8110,8554.06,16599.00513,23410.165266499993,16599.00513,23410.165266499993,65.20594779453809,1171040.1492599978,2423256.2077076905,2423256.2077076905,1171040.1492599978,38.604545220819986,92.85714285714286,0,-29.60932133861229,614.2754967058627,643.884818044475,65.20594779453809,71.57691532578832,75.62566486127425
1559347200,8554.06,8618,8452.21,8558.95,7486.04597,21733.92064499999,7486.04597,21733.92064499999,65.26030857670281,1178526.1952299979,2425409.591701353,2425409.591701353,1178526.1952299979,37.1132118568638,85.71428571428571,0,-40.96773544350458,592.6751487400943,633.6428841835989,65.26030857670281,71.09806141219758,70.04413548562052
1559433600,8558.8,8834,8550,8736.55,5865.30128,19665.29462899999,5865.30128,19665.29462899999,67.2609338867052,1184391.4965099979,2427249.7267156066,2427249.7267156066,1184391.4965099979,36.17724299032287,78.57142857142857,0,-40.38215709679082,583.1651878126104,623.5473449094012,67.2609338867052,78.22108571076463,73.6320208162502
1559520000,8736.55,8742.48,8030.46,8107.96,16677.70831,18522.046024499992,16677.70831,18522.046024499992,55.154186625382806,1167713.788199998,2414202.597305146,2414202.597305146,1167713.788199998,33.84515462319666,71.42857142857143,21.428571428571427,-83.69813594822165,518.9246749741242,602.6228109223458,55.154186625382806,39.48856984410622,62.93590565568952
1559606400,8104.95,8104.95,7427,7670.96,30486.59496,18799.25470249999,30486.59496,18799.25470249999,48.60424489698423,1137227.193239998,2405657.1770820487,2405657.1770820487,1137227.193239998,32.441810595785995,64.28571428571429,100,-139.8424739562522,427.8197184770306,567.6621924332828,48.60424489698423,14.669873722188818,44.12650975901993
1559692800,7671.07,7932.87,7570,7789.48,13294.23284,17993.303774499993,13294.23284,17993.303774499993,50.32719433256232,1150521.426079998,2408444.8370616436,2408444.8370616436,1150521.426079998,31.138705427476083,57.142857142857146,92.85714285714286,-165.3134820951649,361.0203398143267,526.3338219094916,50.32719433256232,21.7967528562838,25.318398807526325
1559779200,7787.36,7874.68,7450,7805,12526.09363,16250.922829999992,12526.09363,16250.922829999992,50.56091679173736,1163047.519709998,2416860.455961784,2416860.455961784,1163047.519709998,30.161494596606325,50,85.71428571428571,-176.42024548582003,305.80851505221653,482.22876053803657,50.56091679173736,22.730006013229104,19.73221086390062
1559865600,7805,8134.29,7756.79,7998.13,12669.70212,16330.687193999993,12669.70212,16330.687193999993,53.49342235557134,1175717.221829998,2420390.520250477,2420390.520250477,1175717.221829998,28.571915462573784,42.857142857142854,78.57142857142857,-166.20479096367382,274.4727718334443,440.6775627971181,53.49342235557134,34.343355381840055,26.290038083784367
1559952000,7998.13,8059.99,7786.01,7930.14,5088.52648,15326.595223999993,5088.52648,15326.595223999993,52.31692586203677,1170628.695349998,2420655.737266808,2420655.737266808,1170628.695349998,27.095877695257848,35.714285714285715,71.42857142857143,-159.44574837776878,241.37037732490717,400.81612570267595,52.31692586203677,30.25496091401084,29.10944076969338
1560038400,7930.14,7960,7508.77,7634.58,7667.4864,14439.864688499994,7667.4864,14439.864688499994,47.43313168617614,1162961.208949998,2417263.881760073,2417263.881760073,1162961.208949998,26.327094280896805,28.571428571428573,64.28571428571429,-169.3670146546873,189.10735738431686,358.47437203900415,47.43313168617614,12.482260974143111,25.693525756664716
1560124800,7635.05,8097.35,7516.9,8015.69,9866.5327,14220.868936999992,9866.5327,14220.868936999992,53.465398034504716,1172827.7416499981,2424354.288832432,2424354.288832432,1172827.7416499981,25.226495351542628,21.428571428571427,57.142857142857146,-145.65356594186807,176.40741461166908,322.06098055353715,53.465398034504716,35.39927841250749,26.045500100220533
1560211200,8015.7,8057.19,7702.83,7918.17,7810.19693,13735.24530199999,7810.19693,13735.24530199999,51.826513233626464,1165017.544719998,2426036.4037147486,2426036.4037147486,1165017.544719998,24.204510631428032,14.285714285714286,50,-132.31470214591633,156.66760287114175,288.9823050170581,51.826513233626464,29.535177390258575,25.80557225896977
1560297600,7913.64,8292.43,7817,8176.02,12826.88591,13631.291397499988,12826.88591,13631.291397499988,55.69373346831368,1177844.430629998,2432581.911551076,2432581.911551076,1177844.430629998,22.585083457202195,7.142857142857143,42.857142857142854,-103.19721730677196,159.98578338359312,263.1830006903651,55.69373346831368,45.04028863499702,36.65824814592107
1560384000,8176.03,8329.99,8048.75,8239.04,8631.68241,13324.47786899999,8631.68241,13324.47786899999,56.61052618400775,1186476.1130399979,2435630.806909522,2435630.806909522,1186476.1130399979,20.977316908469554,0,35.714285714285715,-77.91477325877455,165.7895341168969,243.70430737567145,56.61052618400775,57.71428571428578,44.0965839131805
1560470400,8239.04,8738.92,8180.08,8697.46,12739.94681,13692.811203999989,12739.94681,13692.811203999989,62.66278821957817,1199216.059849998,2446480.415895663,2446480.415895663,1199216.059849998,20.50249274701245,14.285714285714286,28.571428571428573,-30.950318173535322,205.0164096587523,235.96672783228763,62.66278821957817,90.29566453447045,64.3500796279178
1560556800,8697.45,8916.63,8588.7,8860.23,9997.19017,13221.12960749999,9997.19017,13221.12960749999,64.5534043564468,1209213.250019998,2453038.814094279,2453038.814094279,1209213.250019998,20.447818605504867,100,21.428571428571427,8.344896766870136,246.3978487908753,238.05295202400515,64.5534043564468,96.2138249095413,81.40792505276589
1560643200,8856.13,9388,8799.7,8975,22620.40483,13443.96301549999,22620.40483,13443.96301549999,65.86587312331983,1231833.654849998,2443899.140070667,2443899.140070667,1231833.654849998,21.272799351317776,100,14.285714285714286,37.69099289194713,285.1666931389391,247.47570024699195,65.86587312331983,78.93931667516573,88.4829353730592
1560729600,8975.78,9475,8975.78,9333.14,20653.50295,13877.113520499992,20653.50295,13877.113520499992,69.64316130682467,1252487.157799998,2452814.708128287,2452814.708128287,1252487.157799998,22.181986452801024,100,7.142857142857143,74.70820268543571,340.8609536037866,266.1527509183509,69.64316130682467,93.07324218749997,89.40879459073572
1560816000,9333.08,9359.48,8919.72,9078.48,16415.43057,14081.504060499992,16415.43057,14081.504060499992,64.20268294317995,1236071.727229998,2448251.7141477596,2448251.7141477596,1236071.727229998,22.834429379861497,92.85714285714286,0,75.31527511340516,360.29684481010736,284.9815696967022,64.20268294317995,80.41876543209874,84.14377476492153
1560902400,9078.48,9319.5,9035.75,9277.54,9225.47104,12957.397071999994,9225.47104,12957.397071999994,66.4114876936458,1245297.198269998,2454748.7216470484,2454748.7216470484,1245297.198269998,23.440269240703365,85.71428571428571,7.142857142857143,81.85304676308249,387.29787815055533,305.44483138747285,66.4114876936458,90.24888888888893,87.91363216949593
1560988800,9277.55,9599,9210.3,9531.21,12144.52282,12734.672956499995,12144.52282,12734.672956499995,69.03368946578207,1257441.721089998,2462657.1899161465,2462657.1899161465,1257441.721089998,24.51226330082134,100,0,95.0638679655006,424.2746663443486,329.210798378848,69.03368946578207,96.75681623553385,89.14149018550722
1561075200,9531.21,10245,9531.21,10236.2,24905.13312,13605.627313999994,24905.13312,13605.627313999994,74.89871408759859,1282346.854209998,2486948.2343785414,2486948.2343785414,1282346.854209998,26.41064087548935,100,14.285714285714286,140.35021252149625,504.64856403071826,364.298351509222,74.89871408759859,99.67838960906066,95.56136491116119
1561161600,10235.59,11215.89,10080,10666.86,38347.9826,15229.761379999993,38347.9826,15229.761379999993,77.67980178986302,1320694.836809998,2488225.3863754408,2488225.3863754408,1320694.836809998,29.045006968626375,100,7.142857142857143,185.5399024562371,596.2232295795184,410.6833271232813,77.67980178986302,85.18985088154689,93.87501890871384
1561248000,10666.87,11284.44,10490,10833.02,17386.67248,15265.209588499993,17386.67248,15265.209588499993,78.6621079307747,1338081.5092899979,2485853.0041982695,2485853.0041982695,1338081.5092899979,31.54001681861593,100,0,210.99743787975132,674.4301244729704,463.4326865932191,78.6621079307747,88.01817631664163,90.96213893574976
1561334400,10833,11091.97,10550.21,11032.32,15499.06962,14515.833321499993,15499.06962,14515.833321499993,79.8098738952302,1353580.5789099978,2497939.0514362813,2497939.0514362813,1353580.5789099978,33.85681167932052,92.85714285714286,0,224.38672659509962,743.9160948370936,519.529368241994,79.8098738952302,92.9607076147319,88.72291160430684
1561420800,11030.8,11788.88,10997,11755.53,25027.56801,15102.500079999993,25027.56801,15102.500079999993,83.31677582392157,1378608.1469199979,2520858.5490489146,2520858.5490489146,1378608.1469199979,36.47127856881745,100,0,262.4332729473857,847.5709594262262,585.1376864788405,83.31677582392157,99.160347241105,93.37974372415954
1561507200,11754.25,13868.44,11350,12927.44,82377.61849,18595.076322999994,82377.61849,18595.076322999994,87.19737052925927,1460985.765409998,2541676.361469213,2541676.361469213,1460985.765409998,39.67222437356277,100,0,341.976895108465,1012.6088053644216,670.6319102559567,87.19737052925927,83.8307538717698,91.9839362425356
1561593600,12927.44,13358.68,10300,11159.29,77276.0021,21825.391321999992,77276.0021,21825.391321999992,63.280764599100586,1383709.763309998,2507819.413238535,2507819.413238535,1383709.763309998,40.4930524413471,92.85714285714286,0,254.95307713872955,989.3232566793686,734.370179540639,63.280764599100586,52.37379490749532,78.45496534012342
1561680000,11159.29,12444.77,10737.87,12360.45,42092.86934,23675.60846499999,42092.86934,23675.60846499999,69.41747863436305,1425802.632649998,2545753.549503664,2545753.549503664,1425802.632649998,41.255249932861126,85.71428571428571,0,257.003284696493,1055.6242854112552,798.6210007147622,69.41747863436305,71.43817687992212,69.21424188639578
1561766400,12360.42,12379.99,11318.94,11865.29,28879.3644,24736.202364999994,28879.3644,24736.202364999994,64.62282157538456,1396923.2682499979,2546614.9904190404,2546614.9904190404,1396923.2682499979,41.963004746409865,78.57142857142857,0,205.93494857684982,1056.0396864358245,850.1047378589747,64.62282157538456,60.48031660728307,61.43076279823356
1561852800,11869.84,12200,10650.06,10761.26,28722.49963,25679.000711499993,28722.49963,25679.000711499993,55.42991347426083,1368200.768619998,2522013.8657569177,2522013.8657569177,1368200.768619998,41.35949433051726,71.42857142857143,0,84.92399655039992,956.2597335469745,871.3357369965746,55.42991347426083,37.21245089639342,56.37698146119959
1561939200,10761.26,11210.52,9953,10577.63,39825.96917,27279.789323499997,39825.96917,27279.789323499997,54.05260544957316,1328374.799449998,2521752.26951563,2521752.26951563,1328374.799449998,39.694191778386624,64.28571428571429,7.142857142857143,-15.037819235171128,852.5384629526106,867.5762821877818,54.05260544957316,33.50179440340128,43.73152063569264
1562025600,10578.23,10925,9651,10829.18,43614.90812,28819.190434,43614.90812,28819.190434,55.677324296322425,1371989.707569998,2558806.4547218806,2558806.4547218806,1371989.707569998,37.71542232084228,57.142857142857146,0,-68.75983547989904,781.6264878379079,850.386323317807,55.677324296322425,37.110387796444634,35.94154436541316
1562112000,10829.19,12014.6,10829.19,11976.42,38216.69449,30298.441038,38216.69449,30298.441038,62.23592025616068,1410206.402059998,2594561.3623269578,2594561.3623269578,1410206.402059998,36.922496396572456,50,0,-33.36588344464667,808.6789690119986,842.0448524566452,62.23592025616068,59.38250031128304,43.331560837043035
1562198400,11976.01,12064.26,11035.01,11136,22601.3893,30791.513162500003,22601.3893,30791.513162500003,55.73010737242064,1387605.012759998,2576395.269224008,2576395.269224008,1387605.012759998,36.22861059117673,42.857142857142854,0,-70.74294847235126,753.6161668662062,824.3591153385574,55.73010737242064,37.000343537234606,44.497743881654145
1562284800,11137.87,11449.51,10761.8,11004.51,20737.39395,31328.523351500007,20737.39395,31328.523351500007,54.76550444725735,1366867.618809998,2570295.3616726487,2570295.3616726487,1366867.618809998,35.16872243995497,35.714285714285715,0,-106.36861577516436,691.398345619602,797.7669613947663,54.76550444725735,32.09316552221253,42.825336456910115
1562371200,10994.99,11723.6,10980.09,11237.77,15612.79262,30978.142741000007,15612.79262,30978.142741000007,56.213383585790965,1382480.411429998,2565504.4931755834,2565504.4931755834,1382480.411429998,34.448925611772324,28.571428571428573,71.42857142857143,-115.50905609658571,653.3806412740341,768.8896973706198,56.213383585790965,37.62400887742328,35.57250597895686
1562457600,11237.77,11620,11084.31,11474.42,11293.24342,30510.129764500005,11293.24342,30510.129764500005,57.692922874833926,1393773.654849998,2570659.595592079,2570659.595592079,1393773.654849998,33.78054284274558,21.428571428571427,64.28571428571429,-107.09030188040799,635.0268200201099,742.1171219005179,57.692922874833926,43.235232747828064,37.65080238248801
1562544000,11474.44,12395,11328.01,12293.53,20423.57586,30710.537029000006,20423.57586,30710.537029000006,62.4255099509171,1414197.230709998,2587198.635997175,2587198.635997175,1414197.230709998,33.87556675650134,14.285714285714286,57.142857142857146,-50.69179278617128,678.7523809178037,729.444173703975,62.4255099509171,62.65720437042377,47.83881533189176
1562630400,12293.39,12829.96,12105.32,12571.11,27431.43633,31620.835293500008,27431.43633,31620.835293500008,63.899287679494165,1441628.6670399979,2595032.4037082177,2595032.4037082177,1441628.6670399979,34.310476959033856,7.142857142857143,50,-1.6206485350462572,727.4183630351672,729.0390115702135,63.899287679494165,69.23892218976441,58.377119769338805
1562716800,12572.12,13202.63,11553.21,12097.96,41379.85773,33082.60203900001,41379.85773,33082.60203900001,59.607528307728806,1400248.8093099978,2580985.399342937,2580985.399342937,1400248.8093099978,33.78695964505027,0,42.857142857142854,-7.620686052803308,719.5131540042094,727.1338400570127,59.607528307728806,65.99706555042503,65.96439737020445
1562803200,12097.48,12097.93,10933,11349,37301.33518,33702.412142000016,37301.33518,33702.412142000016,53.4839245927549,1362947.474129998,2570324.9016980333,2570324.9016980333,1362947.474129998,32.385712031400566,0,35.714285714285715,-65.40792228846522,645.3739371964311,710.7818594848964,53.4839245927549,47.80903416177925,61.01500730065629
1562889600,11348.56,11950,11079.59,11802,18541.26712,32712.076368000016,18541.26712,32712.076368000016,56.40137207997839,1381488.7412499979,2582560.847110424,2582560.847110424,1381488.7412499979,31.084553533011555,85.71428571428571,28.571428571428573,-75.76971189555661,616.0697196154506,691.8394315110072,56.40137207997839,60.56374115546947,58.123280289224645
1562976000,11797.53,11845,10814.4,11370.08,18417.61959,32763.62372350002,18417.61959,32763.62372350002,52.988858845243136,1363071.1216599979,2584004.090811267,2584004.090811267,1363071.1216599979,29.487759381697792,78.57142857142857,21.428571428571427,-112.16380077167412,551.6346805464145,663.7984813180886,52.988858845243136,48.402564456320064,52.25844659118965
1563062400,11370.06,11467.27,10084.4,10185.03,25829.62443,33280.15146400002,25829.62443,33280.15146400002,44.95254320941822,1337241.4972299978,2561933.655757551,2561933.655757551,1337241.4972299978,27.71921834132018,71.42857142857143,14.285714285714286,-210.77394538354008,400.3310495886635,611.1049949722036,44.95254320941822,15.036194648654302,41.334166753481334
1563148800,10190.91,11080.01,9857.27,10854.47,34137.38752,33735.642439500014,34137.38752,33735.642439500014,49.60242317474452,1371378.8847499979,2583477.4479404218,2583477.4479404218,1371378.8847499979,26.347987231827556,64.28571428571429,7.142857142857143,-224.3809858492516,330.62876266063904,555.0097485098906,49.60242317474452,33.88500491323701,32.44125467273718
1563235200,10856.41,11040,9350,9422.72,43610.39597,31797.28131350001,43610.39597,31797.28131350001,41.5237308774687,1327768.488779998,2543620.126520645,2543620.126520645,1327768.488779998,25.645819183523294,57.142857142857146,100,-317.57805125683535,158.03718443884645,475.6152356956818,41.5237308774687,1.8875417571892281,16.936247106360234
1563321600,9429.8,9998,9071,9696.31,35319.42524,29699.45247050001,35319.42524,29699.45247050001,43.42007965712314,1363087.914019998,2555950.301705293,2555950.301705293,1363087.914019998,25.287322373974526,50,100,-346.2204187803924,42.83971222019136,389.06013100058374,43.42007965712314,15.134704704922745,16.969083791783046
1563408000,9696.39,10799,9291,10649.07,33044.51566,29247.034786500015,33044.51566,29247.034786500015,49.55519821849952,1396132.429679998,2582424.042520593,2582424.042520593,1396132.429679998,23.816355825134693,42.857142857142854,92.85714285714286,-288.7675229650803,28.100727294233366,316.86825025931364,49.55519821849952,38.19485287888799,18.405699780333375
1563494400,10652.76,10777.21,10111,10538.06,19825.72994,28794.353063500013,19825.72994,28794.353063500013,48.89001079183405,1376306.699739998,2588016.05241691,2588016.05241691,1376306.699739998,22.450458315497706,35.714285714285715,85.71428571428571,-247.5927164092506,7.37735474775036,254.97007115700097,48.89001079183405,35.5080198372071,29.612525807005998
1563580800,10536.92,11112.31,10360.65,10761.03,18390.50651,28277.753407500015,18390.50651,28277.753407500015,50.332124200786645,1394697.206249998,2589217.3586852243,2589217.3586852243,1394697.206249998,20.961967157970864,28.571428571428573,78.57142857142857,-196.90101499469068,8.843802413637604,205.7448174083283,50.332124200786645,40.90467926702055,38.202517327705266
1563667200,10761.03,10835,10320,10590.7,11939.88001,26883.44894950001,11939.88001,26883.44894950001,49.1902916508052,1382757.326239998,2589829.4224371933,2589829.4224371933,1382757.326239998,19.523137367576055,21.428571428571427,71.42857142857143,-167.55236094512142,-3.695633773073496,163.85672717204793,49.1902916508052,36.78209326585393,37.73159745669391
1563753600,10590.71,10688.14,10060,10323.39,15798.94226,25492.65065650001,15798.94226,25492.65065650001,47.37391794666201,1366958.383979998,2587280.021368206,2587280.021368206,1366958.383979998,18.437641943261344,14.285714285714286,64.28571428571429,-158.92677175610467,-34.80173752308292,124.12503423302175,47.37391794666201,30.3122496448133,35.999674059229314
1563840000,10324.13,10324.28,9800.23,9840.12,18061.15388,24484.873626000008,18061.15388,24484.873626000008,44.196509172949185,1348897.230099998,2571968.450269518,2571968.450269518,1348897.230099998,17.78536242982228,7.142857142857143,57.142857142857146,-177.16200220524877,-97.32746852353921,79.83453368170956,44.196509172949185,18.61541328724985,28.569918732639078
1563926400,9848.9,9919.08,9507.38,9772.6,18264.52161,24268.03024150001,18264.52161,24268.03024150001,43.75495065593994,1330632.708489998,2577236.192062016,2577236.192062016,1330632.708489998,17.564689345923444,0,50,-184.34117133919818,-150.59193049228816,33.74924084691001,43.75495065593994,23.178600099771064,24.035421010611458
1564012800,9772.59,10184.99,9734.58,9883.33,13297.29396,23896.02524200001,13297.29396,23896.02524200001,44.730178096111246,1343930.002449998,2572721.8846100867,2572721.8846100867,1343930.002449998,16.90980559416306,0,42.857142857142854,-172.4186221299055,-181.77403681547185,-9.355414685566366,44.730178096111246,28.21569989579715,23.336571094272742
1564099200,9880.86,9898.03,9657.21,9843,10732.62478,23652.016850000007,10732.62478,23652.016850000007,44.428025570252274,1333197.377669998,2578549.46544321,2578549.46544321,1333197.377669998,16.41240323181731,0,35.714285714285715,-158.39580503523715,-207.3501709796128,-48.95436594437566,44.428025570252274,27.82984859408796,26.408049529885446
1564185600,9843,10248.41,9292,9479.98,18982.09852,24036.459605000007,18982.09852,24036.459605000007,41.697639345114325,1314215.279149998,2567029.1351602417,2567029.1351602417,1314215.279149998,16.459948034973134,0,28.571428571428573,-164.0239858201454,-253.98434821955743,-89.96036239941202,41.697639345114325,17.06735885355154,24.37096911447894
1564272000,9469.37,9669.11,9108.88,9533,10054.76432,23518.01902800001,10054.76432,23518.01902800001,42.25581282446056,1324270.043469998,2572198.2133456357,2572198.2133456357,1324270.043469998,16.7470003269698,0,21.428571428571427,-154.74944813897864,-283.3971725731353,-128.6477244341567,42.25581282446056,22.632525192156024,22.509910879931898
1564358400,9533,9729.87,9356.75,9495.01,10565.18106,22674.706264500008,10565.18106,22674.706264500008,41.94593734228602,1313704.862409998,2569462.909715715,2569462.909715715,1313704.862409998,16.88926262804062,35.714285714285715,14.285714285714286,-142.07570211674908,-306.24235208009304,-164.16664996334396,41.94593734228602,20.771465382523985,20.15711647607724
1564444800,9499.21,9839.83,9371.96,9589.01,9411.17715,21076.272235500008,9411.17715,21076.272235500008,43.058621678448254,1323116.0395599979,2568783.628179486,2568783.628179486,1323116.0395599979,16.789169202624095,28.571428571428573,7.142857142857143,-119.18866415742733,-313.1524801601281,-193.96381600270078,43.058621678448254,25.376351460581702,22.926780678420627
1564531200,9589.01,10135.12,9570.01,10087.3,12849.75202,19853.69307750001,12849.75202,19853.69307750001,48.67442840796775,1335965.7915799979,2579458.670349735,2579458.670349735,1335965.7915799979,16.091020000611593,21.428571428571427,0,-65.02741064530122,-275.2480793093273,-210.22066866402608,48.67442840796775,48.83724412632335,31.661686989809734
1564617600,10089.97,10497,9881,10405.94,14432.58391,19648.25891700001,14432.58391,19648.25891700001,51.938673331937295,1350398.375489998,2589624.270198551,2589624.270198551,1350398.375489998,15.115381935166496,14.285714285714286,71.42857142857143,-5.4199397955406425,-216.9955934084519,-211.57565361291125,51.938673331937295,64.7419675256935,46.31852103753291
1564704000,10404.41,10670,10321.42,10533.01,13217.85849,19388.270862000012,13217.85849,19388.270862000012,53.216491764597755,1363616.233979998,2592453.0390417264,2592453.0390417264,1363616.233979998,14.512401886099251,7.142857142857143,64.28571428571429,42.26319573365268,-158.7466589458454,-201.0098546794981,53.216491764597755,71.08458992827306,61.55460052676335
1564790400,10533.62,10922.08,10500,10820.76,10082.37163,18600.90822200001,10082.37163,18600.90822200001,56.065144944064116,1373698.6056099979,2597694.8785756705,2597694.8785756705,1373698.6056099979,14.378201443382968,0,57.142857142857146,90.13065598976985,-88.34653469228579,-178.47719068205564,56.065144944064116,94.41208912420034,76.74621552605568
1564876800,10822.09,11089.74,10572,10977.51,11813.68818,17484.72325500001,11813.68818,17484.72325500001,57.58041522457483,1385512.293789998,2604386.883190787,2604386.883190787,1385512.293789998,14.526550497960738,100,50,127.03881609323619,-19.6786705655104,-146.7174866587466,57.58041522457483,94.33427905051344,86.61031936766233
1564963200,10977.98,11950,10977.98,11819.49,23345.21086,16471.46399950001,23345.21086,16471.46399950001,64.63583997092772,1408857.504649998,2621463.1212532343,2621463.1212532343,1408857.504649998,15.82588393477893,100,42.857142857142854,198.58334305607133,101.51169216134258,-97.07165089472875,64.63583997092772,95.40638902967844,94.71758573479747
1565049600,11811.75,12320.4,11187,11465.49,24773.06379,15944.145927000009,24773.06379,15944.145927000009,60.10912328254857,1384084.4408599979,2608864.1364024915,2608864.1364024915,1384084.4408599979,17.43026774893463,100,35.714285714285715,211.309530242552,167.06526190846125,-44.24426833409075,60.10912328254857,73.37989487843764,87.70685431954324
1565136000,11465.49,12147,11366.26,11975.03,22145.50162,15399.195225000009,22145.50162,15399.195225000009,64.01558902039946,1406229.9424799979,2621253.8629537327,2621253.8629537327,1406229.9424799979,18.920052719222063,92.85714285714286,28.571428571428573,241.12988204663287,257.16808422420036,16.038202177567477,64.01558902039946,89.24590225189321,86.01072872000316
1565222400,11983.41,12050,11451,11981,14887.12436,15152.26494600001,14887.12436,15152.26494600001,64.0599978440151,1421117.066839998,2632711.232452831,2632711.232452831,1421117.066839998,20.303424477346116,85.71428571428571,21.428571428571427,247.41504820125277,325.30701242913347,77.89196422788068,64.0599978440151,89.43179553607015,84.01919755546704
1565308800,11982.39,12040,11651.89,11856.1,11774.53337,14821.466289000013,11774.53337,14821.466289000013,62.326977239929924,1409342.5334699978,2633327.3999639614,2633327.3999639614,1409342.5334699978,21.587983967032734,78.57142857142857,14.285714285714286,229.7036105419487,365.02147740531655,135.31786686336784,62.326977239929924,85.54267138302114,88.07345639032822
1565395200,11860.62,11969.99,11170,11280.95,13852.26178,14917.08537750001,13852.26178,14917.08537750001,54.95435038306642,1395490.2716899978,2623317.4573241784,2623317.4573241784,1395490.2716899978,21.5309073135524,71.42857142857143,7.142857142857143,168.62258520581844,346.0960983706409,177.47351316482246,54.95435038306642,67.63370615783184,80.8693910256411
1565481600,11280.95,11585,11088.88,11540.76,7329.60367,14493.618448000012,7329.60367,14493.618448000012,57.405442974790546,1402819.8753599979,2629339.870530739,2629339.870530739,1402819.8753599979,21.28443083353701,64.28571428571429,0,136.46118240278935,348.04999116830913,211.5888087655198,57.405442974790546,73.69324987768464,75.6232091395126
1565568000,11540.76,11555.55,11222.4,11389.28,6095.29621,13895.325564500012,6095.29621,13895.325564500012,55.508938371293674,1396724.5791499978,2629351.031061095,2629351.031061095,1396724.5791499978,21.055559816379855,57.142857142857146,0,97.55340302692827,333.5305625491801,235.97715952225184,55.508938371293674,68.41991018979532,69.91562207510398
1565654400,11389.25,11438.39,10746,10854.92,12500.35732,13607.117350000011,12500.35732,13607.117350000011,49.31910011859635,1384224.2218299978,2620783.5408226373,2620783.5408226373,1384224.2218299978,19.725499461892348,50,0,31.799884540158416,275.7270151974499,243.92713065729146,49.31910011859635,46.717374626871106,62.94351156478374
1565740800,10854.92,10859.97,9888.88,10025.86,24889.59168,14186.73223600001,24889.59168,14186.73223600001,41.57328050149184,1359334.6301499978,2602915.70051136,2602915.70051136,1359334.6301499978,19.63730082021051,42.857142857142854,0,-66.21265893771019,161.16130698515371,227.3739659228639,41.57328050149184,5.938345494793826,40.358543437153465
1565827200,10021.13,10445,9470,10300.01,27939.84096,15047.09304500001,27939.84096,15047.09304500001,44.667961424673,1387274.4711099977,2622545.802926149,2622545.802926149,1387274.4711099977,20.120586617667122,35.714285714285715,100,-108.75135788822288,91.4347685625853,200.1861264508082,44.667961424673,29.119071007577897,27.258263709747656
1565913600,10300.01,10539.9,9739.99,10352.78,19532.61039,15074.61863850001,19532.61039,15074.61863850001,45.26888904556083,1406807.0814999978,2632940.0301075964,2632940.0301075964,1406807.0814999978,20.360452897452745,28.571428571428573,92.85714285714286,-128.17026497828505,39.973295227951894,168.14356020623694,45.26888904556083,30.97039012068484,22.00926887435224
1566000000,10352.78,10475.82,9978,10217.79,7308.0123,14937.281037500008,7308.0123,14937.281037500008,43.95384131037868,1399499.0691999977,2632672.266368992,2632672.266368992,1399499.0691999977,20.5831858715394,21.428571428571427,85.71428571428571,-143.77044183547508,-11.569492088106927,132.20094974736816,43.95384131037868,26.234563570025294,28.774674899429396
1566086400,10217.99,10513.45,10066.66,10315.48,6794.79887,14748.76192800001,6794.79887,14748.76192800001,45.194630460552595,1406293.8680699978,2633445.5950525785,2633445.5950525785,1406293.8680699978,20.697153100603646,14.285714285714286,78.57142857142857,-140.98254957906607,-44.02723722646442,96.95531235260164,45.194630460552595,29.661801852371585,28.955585181027292
1566172800,10315.48,10938.76,10265,10920,12220.40059,14889.223100000008,12220.40059,14889.223100000008,52.24081890821051,1418514.2686599977,2644985.472266099,2644985.472266099,1418514.2686599977,19.811678701221528,7.142857142857143,71.42857142857143,-94.1494834561698,-20.73154196761061,73.4179414885592,52.24081890821051,50.87005332584901,35.58880624941535
1566259200,10917.94,10953,10555.7,10769.09,8820.95057,14687.783027500007,8820.95057,14687.783027500007,50.49549589962783,1409693.3180899976,2645639.994347155,2645639.994347155,1409693.3180899976,18.957898468904265,0,64.28571428571429,-70.16001442521,-14.282076542953291,55.877937882256695,50.49549589962783,48.52782966006725,43.019894946095995
1566345600,10768.49,10800,9841.59,10130,17445.30157,14838.418910500008,17445.30157,14838.418910500008,43.818887940670116,1392248.0165199977,2638694.1646645595,2638694.1646645595,1392248.0165199977,19.353208947939535,0,57.142857142857146,-92.74063536249906,-60.04785632086714,32.69277904163192,43.818887940670116,25.58139534883721,41.659759444917874
1566432000,10133.34,10237.53,9759,10107.15,10912.35285,14723.143628500009,10912.35285,14723.143628500009,43.59693136203102,1381335.6636699978,2643660.171143034,2643660.171143034,1381335.6636699978,19.83888257800963,0,50,-103.78840119858637,-97.04272245660104,6.74567874198533,43.59693136203102,24.791828793774304,32.967017934226305
1566518400,10105.61,10478,10035.84,10410.85,9413.54658,14689.70237600001,9413.54658,14689.70237600001,47.4098239059971,1390749.210249998,2650214.4828178096,2650214.4828178096,1390749.210249998,19.708634518540016,0,42.857142857142854,-85.95224186485157,-100.69462358907913,-14.742381724227563,47.4098239059971,37.634150536602164,29.33579155973794
1566604800,10413.45,10429,9886.26,10147.96,7987.2225,14498.379092000008,7987.2225,14498.379092000008,44.599260124843894,1382761.987749998,2649929.8660894497,2649929.8660894497,1382761.987749998,19.83024492464397,0,35.714285714285715,-86.90974635131235,-123.379564663368,-36.46981831205565,44.599260124843894,32.054846335697356,31.49360855535799
1566691200,10148,10374.85,9899.95,10138.72,7288.07883,13695.52249050001,7288.07883,13695.52249050001,44.49940694161741,1375473.908919998,2649970.3809938743,2649970.3809938743,1375473.908919998,19.943168873169075,0,28.571428571428573,-83.21112593979831,-140.48372573680354,-57.27259979700523,44.49940694161741,32.064443432188135,33.91781343482927
1566777600,10142,10680,10140.9,10361.65,14125.39542,13163.13907200001,14125.39542,13163.13907200001,47.55050920869012,1389599.304339998,2647413.0844014203,2647413.0844014203,1389599.304339998,19.274020386365446,0,21.428571428571427,-61.78182244357113,-134.49987785146914,-72.718055407898,47.55050920869012,45.298441873815655,36.47257721390043
1566864000,10361.65,10379.87,10019.56,10171.85,7514.30186,12431.579084000012,7514.30186,12431.579084000012,45.268748965601006,1382085.002479998,2646250.8295579306,2646250.8295579306,1382085.002479998,18.887810306130245,0,14.285714285714286,-56.56128090671315,-143.41965654128944,-86.85837563457629,45.268748965601006,47.326365475387746,41.56308359379723
1566950400,10171.95,10277,9522.93,9714.31,17637.0833,12569.077031000012,17637.0833,12569.077031000012,40.2540798347069,1364447.9191799979,2637566.1909963605,2637566.1909963605,1364447.9191799979,19.388103452143095,42.857142857142854,7.142857142857143,-78.73137347417051,-185.27259247728944,-106.54121900311893,40.2540798347069,16.474039109912304,36.36628215303862
1567036800,9714.01,9717.03,9321.73,9495,14421.71171,12701.435948000013,14421.71171,12701.435948000013,38.07678087080536,1350026.207469998,2635787.282160085,2635787.282160085,1350026.207469998,20.156573912551806,35.714285714285715,100,-101.52446518957106,-233.44680049008275,-131.9223353005117,38.07678087080536,10.62178548002479,24.807396688441667
1567123200,9494.8,9699,9337.97,9582.42,8734.16519,12445.531118500014,8734.16519,12445.531118500014,39.48195486576427,1358760.372659998,2638880.7583333817,2638880.7583333817,1358760.372659998,20.87015362578846,28.571428571428573,92.85714285714286,-103.70700235463818,-261.5560882438094,-157.84908588917125,39.48195486576427,15.980800235399439,14.358874941778893
1567209600,9582.42,9707.48,9436.2,9600.86,4057.21637,12281.911753500013,4057.21637,12281.911753500013,39.79231313311651,1362817.589029998,2639748.7944514696,2639748.7944514696,1362817.589029998,21.50674761251994,21.428571428571427,85.71428571428571,-97.02260422969243,-279.1273411762868,-182.10473694659436,39.79231313311651,17.111207831934685,14.571264515786353
1567296000,9600.86,9840,9539.58,9766.52,4200.86499,12187.190192500013,4200.86499,12187.190192500013,42.6383560258601,1367018.454019998,2641894.672693149,2641894.672693149,1367018.454019998,21.680903124964036,14.285714285714286,78.57142857142857,-75.5146194332714,-276.4980112381836,-200.9833918049122,42.6383560258601,27.26648562163227,20.119497896322184
1567382400,9766.62,10486.77,9756.54,10381.26,11794.07474,12151.876063500013,11794.07474,12151.876063500013,51.752622290359895,1378812.528759998,2650280.5258431914,2650280.5258431914,1378812.528759998,20.149820598064846,7.142857142857143,71.42857142857143,-17.011632235093145,-222.24793209877862,-205.23629986368547,51.752622290359895,64.95123431436858,36.442975922645225
1567468800,10381.26,10790,10280,10628.48,15518.03507,11683.298233000012,15518.03507,11683.298233000012,54.85895883978837,1394330.563829998,2655969.254934735,2655969.254934735,1394330.563829998,19.323406436769417,0,64.28571428571429,38.196787640372406,-157.49031531321998,-195.6871029535924,54.85895883978837,88.39724813464385,60.20498935688161
1567555200,10628.48,10833.14,10380,10581.84,12180.83979,10895.348174500014,12180.83979,10895.348174500014,54.15062516250902,1382149.724039998,2654639.722481159,2654639.722481159,1382149.724039998,18.642932578887887,100,57.142857142857146,69.60560305197001,-108.68009913862988,-178.2857021905999,54.15062516250902,83.37314163595588,78.90720802832281
1567641600,10581.84,10666.43,10452.15,10574.73,7432.49315,10290.342312500012,7432.49315,10290.342312500012,54.03608180147508,1374717.230889998,2655710.822856705,2655710.822856705,1374717.230889998,18.01106399656932,92.85714285714286,50,86.81485245768391,-69.76713661849499,-156.5819890761789,54.03608180147508,82.9027199767105,84.8910365824368
1567728000,10574.28,10939.34,10182,10308.92,15732.61922,10711.572658500012,15732.61922,10711.572658500012,49.79534255057288,1358984.611669998,2645251.354484151,2645251.354484151,1358984.611669998,17.997519938507764,100,42.857142857142854,77.51445345221094,-59.688922260915206,-137.20337571312615,49.79534255057288,61.02768899796615,75.76785020354423
1567814400,10308.9,10580,10304.52,10484.37,4381.37519,10590.901474500011,4381.37519,10590.901474500011,52.44806986730864,1363365.986859998,2646590.832553346,2646590.832553346,1363365.986859998,17.98494331316489,92.85714285714286,35.714285714285715,80.06937390109337,-37.11665833675943,-117.1860322378528,52.44806986730864,71.87393747565858,71.9347821501118
1567900800,10484.37,10595,10231.13,10398.97,4915.58032,10225.66046100001,4915.58032,10225.66046100001,51.03454950702141,1358450.406539998,2646210.009157021,2646210.009157021,1358450.406539998,17.746067851724195,85.71428571428571,28.571428571428573,73.09171385019606,-25.821389925107724,-98.91310377530378,51.03454950702141,66.59454380227615,66.49872342530035
1567987200,10401.13,10541.75,10059.99,10310,9745.08707,10271.867286000012,9745.08707,10271.867286000012,49.53669379958922,1348705.3194699981,2646579.374172585,2646579.374172585,1348705.3194699981,17.00434482386057,78.57142857142857,21.428571428571427,60.110577628086816,-23.77488174019527,-83.88545936828208,49.53669379958922,61.094454163859034,66.52097848059798
1568073600,10310.01,10389.26,9916,10093.01,8098.58995,9804.53170500001,8098.58995,9804.53170500001,45.99131735299826,1340606.7295199982,2644538.8977629202,2644538.8977629202,1340606.7295199982,15.898431832095222,71.42857142857143,14.285714285714286,35.74012997212655,-39.21029690312389,-74.95042687525044,45.99131735299826,47.68021958321229,58.45640584978255
1568160000,10093,10297.12,9851.97,10160.2,8374.05434,9677.616779500011,8374.05434,9677.616779500011,47.250258075363654,1348980.7838599982,2647761.5401283824,2647761.5401283824,1348980.7838599982,14.83826100482866,64.28571428571429,7.142857142857143,23.562866411450287,-45.49684386093759,-69.05971027238787,47.250258075363654,51.833878376122854,53.53618404106478
1568246400,10158.81,10460,10040,10423.72,7625.26399,9588.20265000001,7625.26399,9588.20265000001,51.97821608398157,1356606.047849998,2654069.4489871575,2654069.4489871575,1356606.047849998,14.172369821188807,57.142857142857146,0,32.142024096782656,-28.882180151409557,-61.02420424819221,51.97821608398157,67.80132011964751,55.7718060263276
1568332800,10423.85,10452.5,10157,10365.93,6909.04914,9534.29398200001,6909.04914,9534.29398200001,50.90075573243101,1349696.998709998,2656930.3330912874,2656930.3330912874,1349696.998709998,13.55404229352323,50,0,32.70265914232944,-20.145880320280412,-52.84853946260985,50.90075573243101,61.85252205383397,60.49590684986816
1568419200,10365.94,10439,10223.36,10360.25,4470.33,9393.40654050001,4470.33,9393.40654050001,50.78931790600617,1345226.668709998,2658135.605703975,2658135.605703975,1345226.668709998,12.979881017833767,42.857142857142854,0,31.459052612647305,-13.52472369680072,-44.983776309448025,50.78931790600617,58.62933645767845,62.76105954372003
1568505600,10360.01,10380,10263.39,10304.46,2745.27964,8824.400751500008,2745.27964,8824.400751500008,49.63976017650464,1342481.389069998,2657324.0990648293,2657324.0990648293,1342481.389069998,12.446731261836408,35.714285714285715,0,25.88016964850879,-12.633564248812036,-38.513733897320826,49.63976017650464,46.32397700371987,55.601945171744156
1568592000,10303.66,10379.98,10068.42,10262.54,7785.74159,8837.972738000008,7785.74159,8837.972738000008,48.74695743392747,1334695.647479998,2659240.297116958,2659240.297116958,1334695.647479998,11.87803612803152,28.571428571428573,0,18.702638522664294,-15.135435743990456,-33.83807426665475,48.74695743392747,37.758076827574904,47.5704634296578
1568678400,10262.54,10276.18,10135.44,10185.39,5716.19104,8241.928125000008,5716.19104,8241.928125000008,47.069077547385774,1328979.456439998,2657581.5700878715,2657581.5700878715,1328979.456439998,11.349962075212693,21.428571428571427,57.142857142857146,8.608440349303958,-23.077523830024802,-31.68596417932876,47.069077547385774,30.66297580400414,38.24834321176636
1568764800,10185.42,10258,10074.08,10155.26,5627.59566,7802.222322500007,5627.59566,7802.222322500007,46.39740906811892,1323351.860779998,2656921.8758597854,2656921.8758597854,1323351.860779998,11.087734778306414,14.285714285714286,50,0.1963724997533376,-31.440498554637088,-31.636871054390426,46.39740906811892,27.8920698566266,32.104374162735276
1568851200,10156.22,10379.15,9585.86,10275.01,15625.03864,8146.765995000007,15625.03864,8146.765995000007,49.48286311641778,1338976.8994199978,2668444.5269139856,2668444.5269139856,1338976.8994199978,12.312849091249046,7.142857142857143,100,2.8441497261841384,-28.08168389666025,-30.92583362284439,49.48286311641778,50.91689570588409,36.49064712217167
1568937600,10275.01,10309.84,10056.3,10168.85,6183.9324,8253.101796500006,6183.9324,8253.101796500006,46.90521009010725,1332792.9670199978,2667750.865016628,2667750.865016628,1332792.9670199978,13.450455238981487,0,92.85714285714286,-2.138308101604789,-33.59871874985038,-31.46041064824559,46.90521009010725,57.77097330400144,45.52664628883743
1569024000,10168.85,10170.15,9917.34,9973.99,5043.09398,8295.213246000007,5043.09398,8295.213246000007,42.52622980048541,1327749.8730399979,2664967.8974079504,2664967.8974079504,1327749.8730399979,14.857819992417104,7.142857142857143,85.71428571428571,-17.297813910635952,-53.08267803654053,-35.784864125904576,42.52622980048541,38.46146223517049,49.0497770816854
1569110400,9973.99,10097,9848.37,10026.8,5276.96678,7969.357848000005,5276.96678,7969.357848000005,44.05071973616418,1333026.8398199978,2667264.9899333874,2667264.9899333874,1333026.8398199978,16.333260160631255,0,78.57142857142857,-22.196263873109764,-63.53019396729178,-41.333930094182016,44.05071973616418,46.128738662398284,47.4537247338568
1569196800,10026.79,10051.15,9609.37,9693.74,11355.90322,7761.251255500005,11355.90322,7761.251255500005,37.32622133048239,1321670.9365999978,2660246.528673962,2660246.528673962,1321670.9365999978,18.239615513990408,0,71.42857142857143,-44.98123014142223,-97.5604677709598,-52.57923762953757,37.32622133048239,12.341272565035265,32.31049115420141
1569283200,9693.74,9777.16,8159.35,8530.01,38736.24053,9089.021292500005,38736.24053,9089.021292500005,23.70808260524724,1282934.6960699977,2639260.178322475,2639260.178322475,1282934.6960699977,21.768200596517694,14.285714285714286,100,-130.6915902098321,-215.94372539182768,-85.2521351819956,23.70808260524724,16.111099037228605,24.860370088220776
1569369600,8530.01,8743.86,8222.01,8438.35,23524.447,9893.618985000005,23524.447,9893.618985000005,22.996416632240766,1259410.2490699978,2635240.488873419,2635240.488873419,1259410.2490699978,25.04474388743589,7.142857142857143,92.85714285714286,-182.63441392096314,-313.5451525831995,-130.91073866223638,22.996416632240766,12.12700758481299,13.526459729025683
1569456000,8438.35,8464.08,7712.45,8060,27664.80382,10490.228215000006,27664.80382,10490.228215000006,20.289088616874665,1231745.4452499978,2633159.8223753483,2633159.8223753483,1231745.4452499978,28.433326095406997,0,100,-228.56909664627307,-416.6221094700777,-188.05301282380464,20.289088616874665,12.684075108118469,13.64072724338675
1569542400,8060,8290,7861.02,8193.99,15914.72654,11066.895782500007,15914.72654,11066.895782500007,23.714298477555005,1247660.1717899977,2641950.8000454456,2641950.8000454456,1247660.1717899977,31.57986671709446,0,92.85714285714286,-235.11272394040685,-481.9439177493132,-246.83119380890633,23.714298477555005,17.66114687058737,14.15740985450634
1569628800,8193.99,8343,8015.25,8217.47,9039.56652,11273.095092500005,9039.56652,11273.095092500005,24.327940865907607,1256699.7383099978,2644065.96207876,2644065.96207876,1256699.7383099978,34.28308484810822,0,85.71428571428571,-223.14039363846098,-525.7566858569826,-302.6162922185216,24.327940865907607,18.931978782028434,16.425733586911488
1569715200,8217.47,8246.87,7902.96,8052.4,7142.38364,11142.959921000005,7142.38364,11142.959921000005,22.931388267944655,1249557.354669998,2643130.771083124,2643130.771083124,1249557.354669998,36.87817770052501,0,78.57142857142857,-211.7144675858258,-567.2593767008038,-355.54490911497805,22.931388267944655,12.743999130281567,16.445708260965855
1569801600,8054.09,8393.23,7701,8304.96,15142.63378,11495.162112500006,15142.63378,11495.162112500006,29.591172498117416,1264699.988449998,2654411.5662148115,2654411.5662148115,1264699.988449998,39.434985213657875,0,100,-174.09527201794447,-573.1639991374086,-399.06872711946414,29.591172498117416,22.551388085058687,18.075788665789627
1569888000,8304.95,8535,8200,8321.52,12266.37228,11689.778009500005,12266.37228,11689.778009500005,30.018192506755142,1276966.360729998,2651044.35548386,2651044.35548386,1276966.360729998,41.18868513646428,14.285714285714286,92.85714285714286,-136.69487328048825,-569.9373187200745,-433.2424454395862,30.018192506755142,23.16972537012492,19.48837086182179
1569974400,8321.87,8391,8168.85,8381.72,7040.89123,11660.559371500005,7040.89123,11660.559371500005,31.641257898415205,1284007.251959998,2657497.000298245,2657497.000298245,1284007.251959998,42.84738169899599,7.142857142857143,85.71428571428571,-98.29564474485358,-556.1120013706532,-457.8163566257996,31.641257898415205,25.417545693855814,23.712886383013203
1570060800,8381.72,8419.95,8059.22,8240.41,7778.13278,11704.013553500006,7778.13278,11704.013553500006,29.888903535917706,1276229.1191799978,2657532.5779299554,2657532.5779299554,1276229.1191799978,44.496106115984006,0,78.57142857142857,-73.9191818321832,-550.2153339160286,-476.2961520838454,29.888903535917706,20.676239248094934,23.08783677069195
1570147200,8241.27,8241.35,8002.21,8156.67,7715.29458,11866.261782500007,7715.29458,11866.261782500007,28.86857896858625,1268513.8245999978,2659783.866948072,2659783.866948072,1268513.8245999978,46.083878743139906,0,71.42857142857143,-55.76731153825665,-546.0052915066663,-490.2379799684096,28.86857896858625,18.45452888645891,21.51610460946995
1570233600,8156.68,8200,8020.2,8147.63,3826.843,11920.339950500007,3826.843,11920.339950500007,28.754461074167722,1264686.9815999977,2661381.435555302,2661381.435555302,1264686.9815999977,47.558239039784674,0,64.28571428571429,-37.57416187197077,-537.2056823083731,-499.6315204364023,28.754461074167722,18.640651085141908,19.257139739898648
1570320000,8147.63,8176.18,7780.85,7859.79,8697.95405,11965.950573500008,8697.95405,11965.950573500008,25.322082644329186,1255989.0275499977,2656157.1186828855,2656157.1186828855,1255989.0275499977,49.16988854879591,0,57.142857142857146,-38.01557962005137,-547.1509949614665,-509.1354153414151,25.322082644329186,6.7565900048933045,14.617256658831437
1570406400,7859.79,8310.57,7762.35,8209,10012.02172,12180.742107500006,10012.02172,12180.742107500006,35.397428161709556,1266001.0492699977,2662459.2391001224,2662459.2391001224,1266001.0492699977,49.96003715808058,0,50,-9.371955433374978,-520.8503596331338,-511.47840419975887,35.397428161709556,24.468249075215784,16.621830055083727
1570492800,8208.99,8342.97,8107.26,8180,5857.5545,12192.240049500007,5857.5545,12192.240049500007,34.97541438477853,1260143.4947699977,2660216.9619691777,2660216.9619691777,1260143.4947699977,50.52357476360767,0,42.857142857142854,11.884945405606231,-496.6222224427511,-508.5071678483573,34.97541438477853,45.931381009915015,25.718740030008096
1570579200,8180,8712.45,8121,8590,14459.79208,12133.977721500007,14459.79208,12133.977721500007,44.96533017767905,1274603.2868499977,2668689.429540949,2668689.429540949,1274603.2868499977,49.305954365469844,0,35.714285714285715,55.38653550881935,-439.2739984623331,-494.66053397115246,44.96533017767905,87.89361807306337,52.76441605273144
1570665600,8590.01,8660,8452.5,8587.5,7946.65572,12222.113887500007,7946.65572,12222.113887500007,44.92001278230548,1266656.6311299978,2671083.000540949,2671083.000540949,1266656.6311299978,48.175306852913295,92.85714285714286,28.571428571428573,84.09921721267108,-389.53651245531364,-473.6357296679847,44.92001278230548,87.64644816847094,73.82381575048316
1570752000,8587.49,8826,8226,8267.33,12446.85928,12592.302152500008,12446.85928,12592.302152500008,39.43814070503431,1254209.7718499978,2660350.9035744234,2660350.9035744234,1254209.7718499978,47.59543920883788,100,21.428571428571427,81.57269502769003,-371.66986088337217,-453.2425559110622,39.43814070503431,50.34044444444444,75.29350356199298
1570838400,8263.02,8425,8261.46,8309.03,3046.41896,12480.774761500008,3046.41896,12480.774761500008,40.457335952455814,1257256.1908099977,2659076.750114328,2659076.750114328,1257256.1908099977,47.05699068219643,92.85714285714286,14.285714285714286,82.50626685022633,-350.1097223482793,-432.61598919850564,40.457335952455814,54.04711111111117,64.01133457467559
1570924800,8309.03,8469.02,8146.47,8282.97,5858.05417,12205.882309000008,5858.05417,12205.882309000008,40.00424302130687,1251398.1366399978,2658176.8382119145,2658176.8382119145,1251398.1366399978,46.79264706459879,85.71428571428571,7.142857142857143,81.04728581418414,-331.3068819307755,-412.3541677449596,40.00424302130687,51.73066666666661,52.039407407407474
1571011200,8282.96,8409,8215.66,8355,4462.51877,10492.196221000007,4462.51877,10492.196221000007,41.93974073410442,1255860.6554099978,2660146.587626582,2660146.587626582,1255860.6554099978,46.547185133972405,78.57142857142857,0,84.24033267992075,-307.05375189505867,-391.2940845749794,41.93974073410442,55.718516429276534,53.832098069018166
1571097600,8355,8420,8085.65,8162.44,8558.58254,9743.902998000007,8558.58254,9743.902998000007,38.375526367418935,1247302.0728699977,2655519.2959688706,2655519.2959688706,1247302.0728699977,46.5915865859054,71.42857142857143,42.857142857142854,73.10427928901294,-299.91373546371324,-373.0180147527262,38.375526367418935,37.61481690405673,48.35466666666668
1571184000,8162.44,8171.59,7908.86,7993.54,8490.00977,8785.163295500006,8490.00977,8785.163295500006,35.52381278990488,1238812.0630999978,2652502.083575064,2652502.083575064,1238812.0630999978,46.971405285239925,64.28571428571429,35.714285714285715,54.91410026420192,-304.37538942247375,-359.28948968667567,35.52381278990488,21.735533305128538,38.35628887948732
1571270400,7995.81,8124.42,7937.01,8076.2,4909.28487,8234.891212000006,4909.28487,8234.891212000006,37.95387103918503,1243721.347969998,2654885.0815187376,2654885.0815187376,1243721.347969998,47.32409407747913,57.142857142857146,28.571428571428573,49.184902362999196,-297.80836173292664,-346.99326409592584,37.95387103918503,29.50688666384615,29.619078957677193
1571356800,8076.94,8117.77,7814.08,7954.16,7071.37822,8136.481797000008,7071.37822,8136.481797000008,35.80806869364545,1236649.9697499978,2654337.188833708,2654337.188833708,1236649.9697499978,47.88337068602178,50,21.428571428571427,38.39076191674019,-299.0048117000006,-337.39557361674076,35.80806869364545,18.03318760870583,23.091869192560228
1571443200,7954.15,8099.98,7873.46,7965.28,4839.5037,8021.337800000008,4839.5037,8021.337800000008,36.16222797782265,1241489.4734499978,2653421.075825338,2653421.075825338,1241489.4734499978,48.402698965382804,42.857142857142854,14.285714285714286,33.39832008804649,-295.6476735066826,-329.0459935947291,36.16222797782265,19.07864429088511,22.20623952114575
1571529600,7965.27,8309,7875.01,8236.12,6162.06248,7572.309235000008,6162.06248,7572.309235000008,44.23256318887367,1247651.535929998,2657513.5463168477,2657513.5463168477,1247651.535929998,47.58349710605501,35.714285714285715,7.142857142857143,48.80258472499838,-268.04276268848116,-316.84534741347954,44.23256318887367,44.54190758238148,27.217913160657528
1571616000,8235.94,8349.84,8156,8209.92,6137.14764,7265.848003000008,6137.14764,7265.848003000008,43.65759106339865,1241514.3882899978,2654790.709456344,2654790.709456344,1241514.3882899978,46.58695078299919,28.571428571428573,0,57.11596299540554,-245.45039366922265,-302.5663566646282,43.65759106339865,39.11771681555855,34.24608956294177
1571702400,8209.92,8317.14,7998.9,8024.72,6015.88191,7214.597537000007,6015.88191,7214.597537000007,39.72653081707541,1235498.5063799978,2649751.009490262,2649751.009490262,1235498.5063799978,46.09213763879576,21.428571428571427,71.42857142857143,50.27192265837158,-239.72645334166373,-289.9983760000353,39.72653081707541,20.815874772709336,34.82516639021651
1571788800,8024,8049,7296.44,7474.85,19159.9448,7783.688138000007,19159.9448,7783.688138000007,30.845784279688914,1216338.561579998,2639675.591510098,2639675.591510098,1216338.561579998,46.944091725339675,14.285714285714286,100,10.899314544805634,-276.3742328190283,-287.2735473638339,30.845784279688914,11.66413870655618,23.865910098274743
1571875200,7475.54,7509.99,7359.48,7430.87,7972.65537,7796.556177500007,7972.65537,7796.556177500007,30.26306205155946,1208365.9062099978,2639266.126185468,2639266.126185468,1208365.9062099978,47.73519194855903,7.142857142857143,92.85714285714286,-14.537716284381247,-305.4456927193105,-290.90797643492925,30.26306205155946,8.788802008420738,13.756271829228808
1571961600,7430.87,8800.1,7389.91,8668,27140.22339,8962.225197000007,27140.22339,8962.225197000007,55.64605459296319,1235506.1295999978,2661321.6113347784,2661321.6113347784,1235506.1295999978,44.61980477154016,0,85.71428571428571,51.883835629588646,-226.05318189794343,-277.9370175275321,55.64605459296319,91.21476929625045,37.22257000374251
1572048000,8668,10540.49,8645.01,9259.78,53383.41642,11196.498315500006,53383.41642,11196.498315500006,62.64942189874977,1288889.5460199977,2642566.3871537084,2642566.3871537084,1288889.5460199977,44.21696867647489,100,78.57142857142857,131.0956570016027,-114.06744627552871,-245.1631032771314,62.64942189874977,60.52126200274352,53.508277769138296
1572134400,9259.98,9826.72,9102.33,9548.84,19636.44344,11677.719401500008,19636.44344,11677.719401500008,65.51381243967765,1308525.9894599977,2647137.5345429424,2647137.5345429424,1308525.9894599977,43.8429065882,92.85714285714286,71.42857142857143,194.55408020245838,-1.9705030240584165,-196.5245832265168,65.51381243967765,69.43172885744673,73.72258671881362
1572220800,9555.89,9939.69,9180.59,9226.5,16736.98706,12221.691029500007,16736.98706,12221.691029500007,59.98900147970631,1291789.0023999978,2632425.0372100524,2632425.0372100524,1291789.0023999978,43.61168255661115,85.71428571428571,64.28571428571429,205.35043545826443,60.16346109631377,-145.18697436195066,59.98900147970631,59.49538385659901,63.14945823892981
1572307200,9225.06,9575,9068.19,9430.8,12640.21198,12130.712024500008,12640.21198,12130.712024500008,62.16669936507575,1304429.2143799977,2637872.342311672,2637872.342311672,1304429.2143799977,43.11823392378136,78.57142857142857,57.142857142857146,215.7141632696692,124.45572972513582,-91.25843354453336,62.16669936507575,65.7930673078405,64.90672667396214
1572393600,9431.36,9431.36,8991.33,9164.44,9862.69137,12226.513807000007,9862.69137,12226.513807000007,57.75323260157791,1294566.5230099978,2635769.7150421226,2635769.7150421226,1294566.5230099978,42.464458830874804,71.42857142857143,50,194.73536697818764,152.16077517820122,-42.574591799986436,57.75323260157791,57.58234305883081,60.956931407756834
1572480000,9164.45,9433,8950,9159.48,8326.97552,12020.519619000008,8326.97552,12020.519619000008,57.6711260456564,1286239.5474899977,2634665.658080837,2634665.658080837,1286239.5474899977,41.74766767445334,64.28571428571429,42.857142857142854,171.44952298170816,171.73731192714877,0.2877889454406031,57.6711260456564,57.42944775820348,60.268286041625
1572566400,9159.96,9299.99,9057.27,9253.12,7774.28595,12256.912968500006,7774.28595,12256.912968500006,58.86025125024415,1294013.8334399976,2639437.4655990927,2639437.4655990927,1294013.8334399976,41.0820758863477,57.142857142857146,35.714285714285715,153.8400021078783,192.58779158028847,38.747789472410176,58.86025125024415,60.315963070852824,58.442584629295766
1572652800,9253.09,9393,9210,9308.52,4559.28,12191.974260000006,4559.28,12191.974260000006,59.58365531526842,1298573.1134399977,2639787.2595400764,2639787.2595400764,1298573.1134399977,40.60426140626402,50,28.571428571428573,137.9203908334068,211.14827801416868,73.22788718076188,59.58365531526842,62.02370493673035,59.92303858859561
1572739200,9308.52,9380,9068.3,9206.52,4294.51485,12183.574064000008,4294.51485,12183.574064000008,57.576237914037954,1294278.5985899977,2639301.457186496,2639301.457186496,1294278.5985899977,39.723784880031694,42.857142857142854,21.428571428571427,113.53526573170618,215.1469693453946,101.61170361368843,57.576237914037954,58.87948706092695,60.406385022836766
1572825600,9206.52,9600,9127,9412.53,8361.97344,12173.743609000008,8361.97344,12173.743609000008,60.47277865439859,1302640.5720299978,2641035.0197986024,2641035.0197986024,1302640.5720299978,39.26839833224492,35.714285714285715,14.285714285714286,104.52013791574788,232.2618760083733,127.74173809262541,60.47277865439859,65.22988240008634,62.04435813258127
1572912000,9412.63,9474.89,9169.84,9322.09,7581.23123,12128.304682000007,7581.23123,12128.304682000007,58.58178530888564,1295059.3407999978,2641021.3509666845,2641021.3509666845,1295059.3407999978,38.84553939501435,28.571428571428573,7.142857142857143,86.45424555376229,235.80954503482826,149.35529948106597,58.58178530888564,62.442009216873984,62.18379289262915
1572998400,9322.09,9450,9253.66,9341.27,6829.70067,12224.325472000008,6829.70067,12224.325472000008,58.87548507256525,1301889.0414699977,2640286.690285466,2640286.690285466,1301889.0414699977,38.45288466758596,21.428571428571427,0,70.46119884103913,237.4317980323649,166.97059919132576,58.87548507256525,62.30065293727466,63.3241815180784
1573084800,9341.27,9375.16,9075,9198.84,5989.37536,12170.225329000006,5989.37536,12170.225329000006,55.715907753250654,1295899.6661099978,2639239.507386703,2639239.507386703,1295899.6661099978,37.450951161679974,14.285714285714286,0,46.131585584952944,224.63508117251695,178.503495587564,55.715907753250654,57.415777412412965,60.7194798555206
1573171200,9198.85,9246,8660,8763.01,12876.56987,12572.078637500006,12876.56987,12572.078637500006,47.34342121120127,1283023.0962399978,2630889.9527464258,2630889.9527464258,1283023.0962399978,35.24626933146326,7.142857142857143,0,-0.9770733238274545,177.2821539327797,178.25922725660715,47.34342121120127,6.225336062633213,41.98058880410701
1573257600,8763.01,8873.48,8712.52,8807.89,4175.02368,12472.726697500008,4175.02368,12472.726697500008,48.20654002285612,1287198.1199199979,2631662.39437907,2631662.39437907,1287198.1199199979,33.199064774833445,0,0,-29.213666879368276,141.7421436573968,170.95581053676509,48.20654002285612,11.55670513952593,25.065939538190765
1573344000,8807.89,9150,8731.43,9032.23,6070.48229,12469.393430000007,6070.48229,12469.393430000007,52.40613554157267,1293268.6022099978,2634316.8616689825,2634316.8616689825,1293268.6022099978,31.96365758731422,7.142857142857143,85.71428571428571,-32.622104786365554,130.17817955380815,162.8002843401737,52.40613554157267,29.087513382147193,15.62318486143551
1573430400,9032.23,9067.34,8590,8721.54,7049.94294,12521.096481500008,7049.94294,12521.096481500008,46.752327970135035,1286218.6592699979,2631152.4070363846,2631152.4070363846,1286218.6592699979,30.385327202881392,0,100,-54.360072083683946,94.85019423556878,149.21026631925272,46.752327970135035,13.02376237623771,17.88932696597034
1573516800,8721.53,8870,8556.56,8810,6272.87696,11876.743089500009,6272.87696,11876.743089500009,48.457349921866964,1292491.5362299979,2635023.723138804,2635023.723138804,1292491.5362299979,28.81702667763187,42.857142857142854,100,-60.85037502183843,73.14729754195469,133.99767256379312,48.457349921866964,24.2888905926551,22.13338878368006
1573603200,8811,8838.8,8705,8758.34,4486.29334,11702.42498800001,4486.29334,11702.42498800001,47.50076808192608,1288005.2428899978,2634114.3937263917,2634114.3937263917,1288005.2428899978,27.3607476184716,35.714285714285715,92.85714285714286,-66.24694567196975,51.18899047383093,117.43593614580068,47.50076808192608,19.337959058498864,18.883537342463953
1573689600,8758.34,8784.61,8558.01,8630,5607.49346,10625.788491500009,5607.49346,10625.788491500009,45.117880893159146,1282397.7494299978,2632069.861027075,2632069.861027075,1282397.7494299978,25.524067028809235,28.571428571428573,85.71428571428571,-75.41763723416786,23.163889603090865,98.58152683725872,45.117880893159146,7.038258069462592,16.88836924020558
1573776000,8630.01,8773.22,8361,8457.48,10940.92978,8503.66415950001,10940.92978,8503.66415950001,42.06319076292373,1271456.8196499979,2626250.375646543,2626250.375646543,1271456.8196499979,24.18446247683943,21.428571428571427,100,-89.12070419842331,-12.819353410770418,76.3013507876529,42.06319076292373,7.786924939467277,11.387714022476308
1573862400,8457.48,8531.03,8423,8481,2712.3541,7657.45969250001,2712.3541,7657.45969250001,42.63343364861431,1274169.173749998,2626450.481748339,2626450.481748339,1274169.173749998,22.940543964296033,14.285714285714286,92.85714285714286,-92.23229991752874,-38.989024109258025,53.24327580827071,42.63343364861431,9.685230024213075,8.170137677714377
1573948800,8481,8637.01,8371.02,8500.01,3754.25927,7008.32330300001,3754.25927,7008.32330300001,43.12072514874025,1277923.433019998,2626337.4263073346,2626337.4263073346,1277923.433019998,21.41084745612609,7.142857142857143,85.71428571428571,-88.61985325743463,-57.53154076352257,31.088312493912053,43.12072514874025,11.219531880548848,9.56389561474313
1574035200,8501,8501.01,8015,8168.84,9864.13897,6869.519652500011,9864.13897,6869.519652500011,37.193509907115654,1268059.294049998,2622718.011269537,2622718.011269537,1268059.294049998,21.051809922649795,0,100,-103.12796446775624,-97.82164309078325,5.306321376972992,37.193509907115654,10.537780243717007,10.480847382826372
1574121600,8168.84,8197.82,7980.07,8123.36,7361.0099,6744.43557900001,7361.0099,6744.43557900001,36.45246304510129,1260698.284149998,2625044.8003001544,2625044.8003001544,1260698.284149998,20.812147597571116,0,100,-109.76603326681808,-131.90122020654962,-22.135186939731533,36.45246304510129,9.748083242059142,10.501798455441728
1574208000,8123.36,8222.41,8030.05,8082.96,5296.46981,6592.91029350001,5296.46981,6592.91029350001,35.77067214297685,1255401.8143399982,2622661.994637036,2622661.994637036,1255401.8143399982,20.49075755717303,0,92.85714285714286,-110.54896068982906,-160.32138780201785,-49.772427112188794,35.77067214297685,7.375151423922493,9.220338303232944
1574294400,8082.97,8114.97,7374.5,7616.46,16947.03292,7051.5476420000105,16947.03292,7051.5476420000105,29.020886708762006,1238454.7814199983,2616790.370809432,2616790.370809432,1238454.7814199983,21.70092395704327,0,100,-134.56169969156835,-217.97455172664922,-83.41285203508087,29.020886708762006,12.928666844776918,10.017300503586249
1574380800,7616.48,7720,6775.47,7283.03,33676.57846,8507.41256500001,33676.57846,8507.41256500001,25.340334979375825,1204778.2029599983,2619307.2095265626,2619307.2095265626,1204778.2029599983,23.713746861686325,0,100,-163.0767372401319,-287.25877358524576,-124.18203634511386,25.340334979375825,21.37517740352826,13.892998557409287
1574467200,7283.19,7361.41,7102.21,7329.29,7728.4385,8679.10874750001,7728.4385,8679.10874750001,26.728756854716366,1212506.6414599982,2625120.2356452355,2625120.2356452355,1212506.6414599982,25.58279670171202,7.142857142857143,92.85714285714286,-168.31630926053364,-334.5774229207809,-166.26111366024728,26.728756854716366,23.323352410792864,19.209065553032744
1574553600,7329.29,7344,6865,6908.64,10695.02236,8795.76119350001,10695.02236,8795.76119350001,22.61104467615415,1201811.6190999981,2616373.984791667,2616373.984791667,1201811.6190999981,27.61804857077931,0,85.71428571428571,-188.10608188270413,-401.39371601362745,-213.28763413092332,22.61104467615415,5.8105389921766974,16.83635626883267
1574640000,6908.64,7379.99,6526,7127.01,27124.49697,9772.924480500009,27124.49697,9772.924480500009,28.747714928348287,1228936.1160699981,2627428.1407893593,2627428.1407893593,1228936.1160699981,29.88233011700659,0,100,-174.768730432609,-431.74854717168455,-256.97981673907555,28.747714928348287,25.640358361774755,18.258083254914837
1574726400,7127.01,7340.59,7021.84,7162.67,11857.50958,10024.31492600001,11857.50958,10024.31492600001,29.72768121642372,1240793.6256499982,2626048.391674623,2626048.391674623,1240793.6256499982,31.984877267074772,0,92.85714285714286,-152.62889746239296,-447.76593856706677,-295.1370411046738,29.72768121642372,27.528104462123846,19.659667272025164
1574812800,7162.67,7678.76,6850,7523.72,19213.99795,10685.54605550001,19213.99795,10685.54605550001,38.891649799605716,1260007.6235999982,2638073.4851355837,2638073.4851355837,1260007.6235999982,32.60982105703004,0,85.71428571428571,-105.01894447580992,-426.4107216994362,-321.39177722362626,38.891649799605716,44.17407166354528,32.447511495814695
1574899200,7524.73,7660.82,7370.62,7432.41,8646.65142,10474.05013300001,8646.65142,10474.05013300001,37.55771635339532,1251360.9721799982,2633108.960464321,2633108.960464321,1251360.9721799982,33.19012600484565,0,78.57142857142857,-72.56980509541546,-412.1040335928956,-339.5342284974801,37.55771635339532,40.33472468205161,37.34563360257364
1574985600,7432.41,7870.1,7411,7760,10862.803,10808.43909900001,10862.803,10808.43909900001,44.864200532888134,1262223.7751799983,2638761.59308619,2638761.59308619,1262223.7751799983,32.95239762149155,0,71.42857142857143,-24.42558683719784,-370.06621204397743,-345.6406252067796,44.864200532888134,58.455431286445815,47.65474254401429
1575072000,7759.99,7820,7453,7555.92,6130.43999,10811.43698400001,6130.43999,10811.43698400001,41.598601255565995,1256093.3351899981,2636069.5448333607,2636069.5448333607,1256093.3351899981,32.731649836948456,7.142857142857143,64.28571428571429,-2.842063146957969,-349.19320414047706,-346.3511409935191,41.598601255565995,48.788020899948364,49.192725622815324
1575158400,7555.92,7555.92,7237.16,7404.27,8692.60216,10893.56994500001,8692.60216,10893.56994500001,39.308891634372465,1247400.7330299981,2636491.1398559283,2636491.1398559283,1247400.7330299981,32.95044220028228,0,57.142857142857146,4.31472552807395,-340.95773408342666,-345.2724596115006,39.308891634372465,44.46914192839532,50.570864704929896
1575244800,7405.33,7430,7157.33,7305.01,7029.97078,10931.42463600001,7029.97078,10931.42463600001,37.84071745221127,1240370.762249998,2637076.132840115,2637076.132840115,1240370.762249998,33.30308452610475,0,50,5.387518774646935,-338.53806114319195,-343.9255799178389,37.84071745221127,45.92109218879872,46.39275167238086
1575331200,7305.01,7412.85,7237.26,7302.94,6169.05409,11015.56267350001,6169.05409,11015.56267350001,37.80900259481269,1234201.708159998,2635522.18749926,2635522.18749926,1234201.708159998,33.63053811436848,7.142857142857143,42.857142857142854,8.78090345991643,-332.9494505929433,-341.73035405285975,37.80900259481269,45.799069800343055,45.3964346391791
1575417600,7302.94,7775,7080,7198.99,16490.17992,11559.69699650001,16490.17992,11559.69699650001,36.169598842936274,1217711.528239998,2624678.529906399,2624678.529906399,1217711.528239998,32.49286430608835,0,35.714285714285715,6.9291460242076255,-333.06892152260025,-339.9980675468079,36.169598842936274,42.3538518663033,44.69133795181509
1575504000,7199,7489.87,7152.78,7393.54,9248.39097,11475.07005600001,9248.39097,11475.07005600001,41.299662204809174,1226959.919209998,2628641.106986102,2628641.106986102,1226959.919209998,31.43645291268537,0,28.571428571428573,20.920687031182865,-313.8472087578293,-334.7678957890122,41.299662204809174,64.5443047392307,50.899075468625746
1575590400,7393.55,7609.5,7305.75,7540.08,9346.35434,11806.770068000009,9346.35434,11806.770068000009,44.89232828238859,1236306.2735499982,2633715.369683088,2633715.369683088,1236306.2735499982,30.009048731926523,50,21.428571428571427,40.997472349375414,-283.52105535229293,-324.51852770166835,44.89232828238859,75.4467673536195,60.7816413197179
1575676800,7541.76,7643,7487,7502.19,4876.35306,11862.874757500009,4876.35306,11862.874757500009,44.14007784473544,1231429.920489998,2629788.655122849,2629788.655122849,1231429.920489998,28.558124382548712,42.857142857142854,14.285714285714286,51.97257937905982,-259.55280347784355,-311.5253828569034,44.14007784473544,72.62778067108097,70.87295092131046
1575763200,7502.2,7580.84,7387.5,7520,4243.5427,11581.844944000008,4243.5427,11581.844944000008,44.60991391634986,1235673.4631899982,2631361.4919382106,2631361.4919382106,1235673.4631899982,27.520425028685036,35.714285714285715,7.142857142857143,60.10378539358385,-236.39565111492357,-296.4994365085074,44.60991391634986,73.95283089055872,74.00912630508647
1575849600,7520,7659.38,7262.87,7337.51,10252.90755,11726.439826500009,10252.90755,11726.439826500009,40.82120143932933,1225420.5556399983,2624968.6485456442,2624968.6485456442,1225420.5556399983,26.930236359454092,28.571428571428573,0,53.10657134452538,-230.11622232785066,-283.22279367237604,40.82120143932933,47.79041270463681,64.79034142209224
1575936000,7337.51,7398,7156.03,7219.37,7187.12001,11820.972336500008,7187.12001,11820.972336500008,38.53925147727282,1218233.4356299983,2621544.2444213605,2621544.2444213605,1218233.4356299983,26.68874847581894,21.428571428571427,7.142857142857143,40.9795882568319,-231.99830835133616,-272.97789660816807,38.53925147727282,36.20919517694341,52.650812924046384
1576022400,7219.37,7263.31,7124.45,7201.23,5951.57382,11271.199381500008,5951.57382,11271.199381500008,38.186269471170455,1212281.8618099983,2622174.290043959,2622174.290043959,1212281.8618099983,26.555364986695857,14.285714285714286,0,32.561447419019885,-232.2760873343932,-264.8375347534131,38.186269471170455,15.343627388938046,33.11441175683949
1576108800,7201.24,7298.5,7075.01,7185.91,8578.0866,10016.27478850001,8578.0866,10016.27478850001,37.87079812751088,1203703.7752099982,2622109.42375753,2622109.42375753,1203703.7752099982,26.57802990681487,7.142857142857143,100,27.01498159104898,-231.06880776460184,-258.0837893556508,37.87079812751088,13.948106503666203,21.833643023182617
1576195200,7185.91,7299.21,7183.29,7249.9,6119.06808,9935.80626750001,6119.06808,9935.80626750001,40.09687515954098,1209822.8432899984,2623022.6387142586,2623022.6387142586,1209822.8432899984,26.595253337927886,0,92.85714285714286,28.55898723922286,-222.38505530662223,-250.9440425458451,40.09687515954098,23.475482892387745,17.589072261664064
1576281600,7249.9,7264.33,7008.03,7062.91,4334.05486,9617.757892500009,4334.05486,9617.757892500009,36.03387922675918,1205488.7884299983,2620544.634815763,2620544.634815763,1205488.7884299983,27.138279361087374,0,100,18.384174742195285,-227.963824118101,-246.3479988602963,36.03387922675918,7.15542980820633,14.859673068086826
1576368000,7062.92,7220.01,7006.01,7111,4905.20887,8506.79348750001,4905.20887,8506.79348750001,37.780049534278874,1210393.9972999983,2620452.4902379247,2620452.4902379247,1210393.9972999983,27.648392596028508,21.428571428571427,100,16.357969704447584,-225.9005367297368,-242.2585064341844,37.780049534278874,13.652973380668124,14.761295360420798
1576454400,7111,7137,6803.24,6877.03,13170.15135,8572.425576000009,13170.15135,8572.425576000009,33.05254863969422,1197223.8459499984,2613105.837618249,2613105.837618249,1197223.8459499984,28.68085391835943,14.285714285714286,100,1.5076775953964159,-240.37390943993887,-241.8815870353353,33.05254863969422,7.593438709146286,9.467280632673647
1576540800,6877.04,6933.21,6556,6616.62,14047.42654,8314.09700550001,14047.42654,8314.09700550001,28.741691885010937,1183176.4194099985,2603573.429221219,2603573.429221219,1183176.4194099985,30.198592002820305,7.142857142857143,100,-22.292802328345914,-269.7475899457677,-247.45478761742177,28.741691885010937,4.972928630024601,8.739780239946404
1576627200,6616.62,7448.24,6430,7285.53,23097.5572,9036.64229450001,23097.5572,9036.64229450001,47.63456695159563,1206273.9766099984,2619289.222726978,2619289.222726978,1206273.9766099984,29.11602119139628,0,100,8.902415050554396,-236.32676880422878,-245.22918385478317,47.63456695159563,69.59036262180933,27.385576653660138
1576713600,7288.05,7371.7,7044.45,7149.12,10503.12182,9018.65823550001,10503.12182,9018.65823550001,45.013554648276646,1195770.8547899984,2615504.8893616726,2615504.8893616726,1195770.8547899984,28.11077686650254,28.571428571428573,92.85714285714286,21.51863378207389,-218.3308916271908,-239.8495254092647,45.013554648276646,58.494525695879204,44.35260564923777
1576800000,7149.13,7220,7073.66,7190,6020.2411,9013.14829100001,6020.2411,9013.14829100001,45.972971368205634,1201791.0958899984,2619056.8069274374,2619056.8069274374,1201791.0958899984,27.17733570767264,21.428571428571427,85.71428571428571,33.0937213622839,-198.48237370640982,-231.57609506869372,45.972971368205634,61.819779075631615,63.30155579777345
1576886400,7190,7190,7099.57,7143.01,3423.27625,8749.68199550001,3423.27625,8749.68199550001,45.00100093870749,1198367.8196399983,2618922.419769553,2618922.419769553,1198367.8196399983,26.310568917330585,14.285714285714286,78.57142857142857,37.72637748422068,-184.41812321341786,-222.14450069763853,45.00100093870749,57.99752720883699,59.43727732678267
1576972800,7143.01,7521.55,7125,7513.06,10202.1902,8908.29296650001,10202.1902,8908.29296650001,53.3631733348778,1208570.0098399983,2628687.7591573074,2628687.7591573074,1208570.0098399983,24.734749392545933,7.142857142857143,71.42857142857143,64.29333304931737,-141.7778343859918,-206.07116743530918,53.3631733348778,88.09806569164948,69.30512399203943
1577059200,7514.74,7688.99,7259.19,7310.79,15139.35427,9356.80797550001,15139.35427,9356.80797550001,48.9795347971864,1193430.6555699983,2617183.540672938,2617183.540672938,1193430.6555699983,23.84311983553749,100,64.28571428571429,66.54493598950754,-122.88999744842477,-189.4349334379323,48.9795347971864,69.96004733953409,72.01854674667358
1577145600,7310.79,7426.15,7151.08,7255.01,7797.32798,8922.165378500013,7797.32798,8922.165378500013,47.81307052291903,1185633.3275899983,2615278.3586700447,2615278.3586700447,1185633.3275899983,22.574800444374794,92.85714285714286,57.142857142857146,62.63509442721781,-111.14106540391003,-173.77615983112784,47.81307052291903,65.52951175148337,74.52920826088904
1577232000,7255.01,7265.12,7115.5,7192.12,3299.67386,8624.729523000013,3299.67386,8624.729523000013,46.469343379198925,1182333.6537299983,2615358.193046286,2615358.193046286,1182333.6537299983,21.25238345545082,85.71428571428571,50,54.471837533471785,-105.68636291428811,-160.1582004477599,46.469343379198925,60.534237762015586,65.34126561767773
1577318400,7192.12,7432.1,7140,7194.13,7669.04728,8540.864170000012,7669.04728,8540.864170000012,46.52107383199047,1190002.7010099983,2610531.497900941,2610531.497900941,1190002.7010099983,20.627554684231985,78.57142857142857,42.857142857142854,48.08816777333732,-100.04799073108825,-148.13615850442557,46.52107383199047,60.69388954638244,62.25254635329386
1577404800,7194.13,7254,7053.32,7245.83,8492.99054,8721.696044000013,8492.99054,8721.696044000013,47.91529942337571,1198495.6915499982,2618332.962302693,2618332.962302693,1198495.6915499982,19.670508312100146,71.42857142857143,35.714285714285715,46.2160483230673,-90.36609810059144,-136.58214642365874,47.91529942337571,64.80035584079303,62.009494383063746
1577491200,7245.83,7346,7232.55,7302.67,4621.77575,8740.607696500014,4621.77575,8740.607696500014,49.474873441444885,1203117.4672999983,2619424.345047008,2619424.345047008,1203117.4672999983,19.118943077763383,64.28571428571429,28.571428571428573,47.492507868228856,-77.21651158837267,-124.70901945660152,49.474873441444885,69.31508590219146,64.93644376312237
1577577600,7302.67,7531,7278.07,7384.89,6557.32656,8555.828647000013,6557.32656,8555.828647000013,51.726580898799966,1209674.7938599982,2618405.73372948,2618405.73372948,1209674.7938599982,19.230923255224898,57.142857142857146,21.428571428571427,52.186968886523246,-59.47530834844747,-111.66227723497072,51.726580898799966,75.84571759902782,69.98705311400417
1577664000,7384.57,7386.28,7200,7218,7347.23521,8563.834407000013,7347.23521,8563.834407000013,47.134775015675764,1202327.5586499982,2612478.406548039,2612478.406548039,1202327.5586499982,18.962898971002044,50,14.285714285714286,42.7611127146277,-58.21088634168609,-100.97199905631379,47.134775015675764,62.58985377167413,69.25021909096453
1577750400,7218.01,7298.67,7111,7165.72,6755.98321,8604.054876500013,6755.98321,8604.054876500013,45.764252826584425,1195571.5754399982,2609662.183568776,2609662.183568776,1195571.5754399982,18.29900552029402,42.857142857142854,7.142857142857143,32.19571546452521,-60.72735472565728,-92.92307019018249,45.764252826584425,58.43731880316765,65.62429672462326
1577836800,7165.72,7238.14,7136.05,7174.33,3350.6445,8342.682771500013,3350.6445,8342.682771500013,46.04251143961106,1198922.2199399981,2608824.2762900516,2608824.2762900516,1198922.2199399981,17.682533030350854,35.714285714285715,0,25.282408527314004,-61.32005953103999,-86.60246805835399,46.04251143961106,20.15080522543211,47.05932593342468
1577923200,7174.33,7186.18,6903,6945.02,8010.94167,8437.276451000012,8010.94167,8437.276451000012,40.13634909748362,1190911.278269998,2603190.7607728406,2603190.7607728406,1190911.278269998,16.76718350846053,28.571428571428573,100,5.779445720185208,-79.37816090812248,-85.15760662830769,40.13634909748362,5.346123996488562,27.978082675029498
1578009600,6945.02,7401.2,6854.67,7334.45,14056.40678,8923.394047000013,14056.40678,8923.394047000013,51.511904195484135,1204967.685049998,2613813.631781465,2613813.631781465,1204967.685049998,16.093528342998894,21.428571428571427,100,18.881276838107354,-61.5560105806735,-80.43728741878085,51.511904195484135,57.50551347204908,27.667480897989975
1578096000,7334.45,7398,7263.32,7348.63,4742.48064,8915.257635500011,4742.48064,8915.257635500011,51.87053856719248,1209710.165689998,2615079.185346965,2615079.185346965,1209710.165689998,15.467991403641662,14.285714285714286,92.85714285714286,27.74172889469388,-45.7601263004135,-73.50185519510738,51.87053856719248,59.20510116022631,40.685579542921374
1578182400,7348.63,7488.87,7312.22,7355.4,5942.02944,8553.851540000012,5942.02944,8553.851540000012,52.05287626289027,1215652.195129998,2612042.0733280713,2612042.0733280713,1215652.195129998,15.244286734027451,7.142857142857143,85.71428571428571,32.94316928617799,-32.3228935873849,-65.26606287356289,52.05287626289027,60.01654041614725,58.90905168280761
1578268800,7355.4,7805,7343.17,7764.63,11770.47974,8440.004200000012,11770.47974,8440.004200000012,61.53831187610564,1227422.6748699981,2621754.764413788,2621754.764413788,1227422.6748699981,16.089561510951853,100,78.57142857142857,61.18751678605323,11.218333109003652,-49.96918367704958,61.53831187610564,95.75200193616955,71.65788117084776
1578355200,7764.63,8216,7723,8158.52,19857.55268,8278.00397400001,19857.55268,8278.00397400001,68.08325015444991,1247280.227549998,2636981.8419292998,2636981.8419292998,1247280.227549998,17.86712220907822,100,71.42857142857143,101.2756749879785,76.62541005792355,-24.650264930054952,68.08325015444991,95.77765861326793,83.84873365519496
1578441600,8160.01,8469.39,7845,8045.51,23927.80065,8949.23791550001,23927.80065,8949.23791550001,64.68238180700496,1223352.426899998,2628421.8828793624,2628421.8828793624,1223352.426899998,19.99126364518434,100,64.28571428571429,114.10581525128609,117.98200413405266,3.8761888827665736,64.68238180700496,73.74900911613163,88.42622322185643
1578528000,8047.75,8048.67,7744.48,7813.78,9477.71927,9122.11182400001,9477.71927,9122.11182400001,58.256349863727756,1213874.707629998,2623262.5563600184,2623262.5563600184,1213874.707629998,21.480926378249247,92.85714285714286,57.142857142857146,101.34207751020082,130.5537857705176,29.211708260316783,58.256349863727756,59.397914189457005,76.30819397295225
1578614400,7813.78,8199.77,7671,8198.09,13420.63285,9621.97965400001,13420.63285,9621.97965400001,64.54698083574556,1227295.340479998,2636597.9095489634,2636597.9095489634,1227295.340479998,23.155757979206452,85.71428571428571,50,112.28894361943347,169.5728877846086,57.28394416517515,64.54698083574556,83.19832540626241,72.11508290395041
1578700800,8198.09,8290,8000.01,8020,7557.38316,9489.739302000009,7557.38316,9489.739302000009,60.032258925388724,1219737.957319998,2630082.4387953803,2630082.4387953803,1219737.957319998,24.87810920010413,78.57142857142857,42.857142857142854,101.37632071375029,184.00434505736303,82.62802434361274,60.032258925388724,72.16916864843444,71.588469414718
1578787200,8017.47,8185,7963.25,8180.81,3920.75446,8928.809311500008,3920.75446,8928.809311500008,62.577594093065215,1223658.711779998,2633855.0267508714,2633855.0267508714,1223658.711779998,26.284914054868818,71.42857142857143,35.714285714285715,98.73140043374181,206.04227488579,107.31087445204818,62.577594093065215,82.12817082837897,79.16522162769199
1578873600,8180.81,8195.81,8041.95,8104.5,6678.04289,8872.84505700001,6678.04289,8872.84505700001,60.605179523697565,1216980.668889998,2632606.7457583044,2632606.7457583044,1216980.668889998,27.614047389272372,64.28571428571429,28.571428571428573,86.04969380174919,214.87299170423466,128.82329790248548,60.605179523697565,77.40227407847803,77.23320451843053
1578960000,8105.6,8893.69,8105.23,8815.69,27075.82261,10061.65249450001,27075.82261,10061.65249450001,70.07269164033076,1244056.491499998,2654325.5073542264,2654325.5073542264,1244056.491499998,29.97417702273023,100,21.428571428571427,117.80220554454544,276.0760548331673,158.27384928862185,70.07269164033076,96.17463291188905,85.23502593958206
1579046400,8812.58,8900,8550,8808.81,14977.63415,10427.08183800001,14977.63415,10427.08183800001,69.89768801921416,1229078.8573499979,2661498.5103148636,2661498.5103148636,1229078.8573499979,32.173531634171546,100,14.285714285714286,129.6466604837821,320.3321748933495,190.68551440956736,69.89768801921416,95.54155075220133,89.7061525808562
1579132800,8808.81,8850,8580,8714.76,9265.77873,10465.721247500009,9265.77873,10465.721247500009,67.41892447585553,1219813.078619998,2661482.0378193436,2661482.0378193436,1219813.078619998,34.215789487652756,92.85714285714286,7.142857142857143,122.53374848269937,343.85270001294157,221.3189515302422,67.41892447585553,90.94327076804232,94.21981814404428
1579219200,8714.77,9013,8665.67,8899.42,15447.37951,11007.001435500008,15447.37951,11007.001435500008,69.69158334822049,1235260.458129998,2666826.556276479,2666826.556276479,1235260.458129998,36.32745798661056,100,0,121.41893863307905,373.092624821591,251.67368618851197,69.69158334822049,93.5085272735586,93.3311162646008
1579305600,8899.42,8980,8800.1,8909.32,5600.2326,10959.146737500008,5600.2326,10959.146737500008,69.81315535972706,1240860.690729998,2668026.29482236,2668026.29482236,1240860.690729998,38.2882930213571,92.85714285714286,0,112.69254993345311,392.53937360532836,279.84682367187526,69.81315535972706,93.90397347099564,92.78525717086556
1579392000,8908.95,9194.99,8465,8697.53,15218.52907,11352.711430500007,15218.52907,11352.711430500007,63.907387687448555,1225642.1616599981,2662503.1439483548,2662503.1439483548,1225642.1616599981,38.29807950135638,100,0,85.24823577834411,386.40711839480537,301.15888261646126,63.907387687448555,73.13669795120481,86.8497328985864
1579478400,8697.53,8734.84,8504.06,8628.89,5605.81999,11295.203269500005,5605.81999,11295.203269500005,62.07461078153724,1220036.3416699981,2662961.7533660303,2662961.7533660303,1220036.3416699981,38.30716694707001,92.85714285714286,0,56.451765474018885,371.72358945898486,315.271823984966,62.07461078153724,62.85408696907457,76.63158613042505
1579564800,8628.89,8774.31,8465,8722.03,7520.66549,11503.704319000008,7520.66549,11503.704319000008,63.60007717144045,1227557.0071599982,2667940.1124849645,2667940.1124849645,1227557.0071599982,38.4066874430191,85.71428571428571,21.428571428571427,38.51310510813602,363.413205370136,324.90010026199997,63.60007717144045,68.96567562779288,68.31882018269079
1579651200,8722.03,8791.76,8565,8660.38,5481.67186,11377.240828500007,5481.67186,11377.240828500007,61.82737833713776,1222075.3352999983,2667069.8523554886,2667069.8523554886,1222075.3352999983,38.54115232607018,78.57142857142857,14.285714285714286,18.354168540264652,347.8428109373308,329.48864239706614,61.82737833713776,64.92037349326435,65.5800453633773
1579737600,8660.38,8665,8278,8385.22,12206.25942,11284.733460500007,12206.25942,11284.733460500007,54.52284124086014,1209869.0758799983,2661627.185364493,2661627.185364493,1209869.0758799983,37.18859102367093,71.42857142857143,7.142857142857143,-15.807171635641566,309.7296778525142,325.5368494881558,54.52284124086014,46.86513691034715,60.25039534380149
1579824000,8385.21,8509.99,8216.71,8427.26,8635.13451,11479.366154000007,8635.13451,11479.366154000007,55.3900148180057,1218504.2103899983,2665390.629489794,2665390.629489794,1218504.2103899983,35.652458637356226,64.28571428571429,0,-36.675162515884494,279.69289634330016,316.36805885918466,55.3900148180057,37.67109942033224,49.81886994131461
1579910400,8427.58,8437.76,8252.73,8326.81,3783.22269,11371.425816500006,3783.22269,11371.425816500006,52.79933874984611,1214720.9876999983,2664636.7656807886,2664636.7656807886,1214720.9876999983,34.22604999292114,57.142857142857146,7.142857142857143,-57.1269938312991,244.95931657006076,302.08631040135987,52.79933874984611,29.51596927923097,38.01740186997015
1579996800,8326.8,8595,8278.68,8595,5497.33728,11057.768693500006,5497.33728,11057.768693500006,58.39446698593172,1220218.3249799984,2670134.1029607886,2670134.1029607886,1220218.3249799984,33.43697135329107,50,0,-52.58991803693874,236.34891285518643,288.93883089212517,58.39446698593172,47.96451120516202,38.38385996824177
1580083200,8595,8985,8556.6,8895.96,9548.62076,10542.322097500006,9548.62076,10542.322097500006,63.607859706156,1229766.9457399985,2675713.493130357,2675713.493130357,1229766.9457399985,33.75725595728105,42.857142857142854,0,-30.41695248769753,250.91764028250327,281.3345927702008,63.607859706156,72.56001321391861,50.013497899437226
1580169600,8895.95,9418.91,8880.87,9394.5,17578.55425,10224.859777500005,17578.55425,10224.859777500005,70.25655630548808,1247345.4999899985,2691697.0265297047,2691697.0265297047,1247345.4999899985,34.88362123433994,100,0,14.325924007295157,299.2419977793197,284.91607377202456,70.25655630548808,97.9695558143404,72.83136007780703
1580256000,9391.14,9439.83,9224.75,9288.44,12233.065,10362.627064000006,12233.065,10362.627064000006,67.43399050952047,1235112.4349899986,2686708.930005156,2686708.930005156,1235112.4349899986,35.96418986318174,100,64.28571428571429,32.25287668847329,325.2321696326162,292.9792929441429,67.43399050952047,87.62263719013676,86.05073540613193
1580342400,9287.9,9574.68,9171.11,9503.08,12948.41115,10339.015979000007,12948.41115,10339.015979000007,70.05586949657527,1248060.8461399986,2695062.816099577,2695062.816099577,1248060.8461399986,37.19094598487568,100,57.142857142857146,52.825181307759976,359.0107695788429,306.1855882710829,70.05586949657527,94.72742402262199,93.4398723423664
1580428800,9502.71,9522.5,9195.49,9334.98,9719.07563,10447.100602500006,9719.07563,10447.100602500006,65.60133321450937,1238341.7705099985,2693635.3147922503,2693635.3147922503,1238341.7705099985,38.33007666930578,92.85714285714286,50,49.43113514739781,367.97450720533016,318.54337205793234,65.60133321450937,82.34865276847054,88.2329046604098
1580515200,9334.98,9458.08,9285.01,9380.18,4387.43427,10470.434593000007,4387.43427,10470.434593000007,66.2232485355712,1242729.2047799986,2694073.120245783,2694073.120245783,1242729.2047799986,39.387840876276584,85.71428571428571,42.857142857142854,44.69301026826054,374.40963489325804,329.7166246249975,66.2232485355712,85.67715045251369,87.58440908120211
1580601600,9380.18,9480,9140,9323.5,7307.93725,10501.929311000005,7307.93725,10501.929311000005,64.64491031746215,1235421.2675299987,2694653.4564391654,2694653.4564391654,1235421.2675299987,39.52222598622261,78.57142857142857,35.714285714285715,32.75721522226132,370.66314365282415,337.9059284305628,64.64491031746215,81.50327326818707,83.1763588297238
1580688000,9325.01,9619.95,9220,9280.49,11910.30024,9743.653192500005,11910.30024,9743.653192500005,63.40989899965529,1223510.9672899987,2686345.8768468346,2686345.8768468346,1223510.9672899987,39.959762679924005,100,28.571428571428573,17.73348120178514,360.0727799327942,342.3392987310091,63.40989899965529,75.80884239331827,80.99642203800637
1580774400,9280.49,9350,9078.05,9164.33,8190.90076,9404.316523000005,8190.90076,9404.316523000005,60.07194652361177,1215320.0665299986,2683352.335289429,2683352.335289429,1215320.0665299986,39.582647532938246,92.85714285714286,21.428571428571427,-3.1468244807140877,338.4057681301165,341.5525926108306,60.07194652361177,67.53085715914597,74.9476576068838
1580860800,9164.33,9769.7,9150,9613.82,13265.27496,9604.291334500007,13265.27496,9604.291334500007,67.2550962656085,1228585.3414899986,2689944.087381058,2689944.087381058,1228585.3414899986,40.134811928435546,100,14.285714285714286,9.502298094616492,353.4304652291012,343.9281671344847,67.2550962656085,89.96258829741332,77.76742928329254
1580947200,9613.91,9857,9521.47,9763.01,12672.1619,9465.530454000007,12672.1619,9465.530454000007,69.23351846952336,1241257.5033899986,2695516.696352968,2695516.696352968,1241257.5033899986,40.80380456516634,100,7.142857142857143,23.317826717981802,373.0754505319619,349.7576238139801,69.23351846952336,94.26991568564098,83.92112038073344
1581033600,9763.01,9885,9713.99,9808.05,8516.67938,9611.352793000007,8516.67938,9611.352793000007,69.82623643859164,1249774.1827699987,2696368.8125110394,2696368.8125110394,1249774.1827699987,41.47601514559098,100,0,30.440447485288928,387.8081831705913,357.36773568530236,69.82623643859164,95.28570640886613,93.17273679730683
1581120000,9807.92,9955,9653.47,9905.64,8100.98545,9255.475612000007,8100.98545,9255.475612000007,71.12429554528016,1257875.1682199987,2701817.5600954075,2701817.5600954075,1257875.1682199987,42.23062070604385,100,0,36.27894201772568,402.7164132074595,366.4374711897338,71.12429554528016,97.05545480576497,95.53702563342405
1581206400,9905.64,10178.91,9888.76,10168.35,9649.76377,9457.672801000008,9649.76377,9457.672801000008,74.32621796489227,1267524.9319899988,2710764.9181758594,2710764.9181758594,1267524.9319899988,43.31554624291066,100,0,51.461393174998136,430.7642126584815,379.30281948348335,74.32621796489227,99.34907631710342,97.23007917724487
1581292800,10168.36,10199,9736,9851.78,13249.6016,9744.119606500008,13249.6016,9744.119606500008,64.97623922812734,1254275.3303899989,2704141.834386866,2704141.834386866,1254275.3303899989,43.46693445039587,100,0,34.618978923810175,422.57654313824605,387.9575642144359,64.97623922812734,73.65813690607152,90.02088934298
1581379200,9851.78,10400,9706,10270.01,16722.08018,10306.140022500007,16722.08018,10306.140022500007,70.29310772586523,1270997.410569999,2714599.6402077936,2714599.6402077936,1270997.410569999,43.98702499386911,100,0,45.40122236271094,444.70909216782456,399.3078698051136,70.29310772586523,90.16679904686261,87.7246707566792
1581465600,10270.01,10483.86,10250,10351.13,13740.99926,10382.877014500007,13740.99926,10382.877014500007,71.2061488519114,1284738.4098299989,2712742.9072196125,2712742.9072196125,1284738.4098299989,44.61742961033281,100,42.857142857142854,51.31579182626626,463.4526095879464,412.13681776168016,71.2061488519114,90.55846807178771,84.79446800824063
1581552000,10351.13,10522.51,10083.1,10236.49,17101.29968,10806.185273000006,17101.29968,10806.185273000006,68.0242259958416,1267637.110149999,2707581.109862797,2707581.109862797,1267637.110149999,44.30300853337185,100,35.714285714285715,41.25944110131411,463.71111913832283,422.4516780370087,68.0242259958416,80.19882862799938,86.97469858221659
1581638400,10236.49,10395.66,10102.5,10371.33,8026.51046,11018.349661500008,8026.51046,11018.349661500008,69.73719154002414,1275663.620609999,2714275.344435965,2714275.344435965,1275663.620609999,44.01104610476524,92.85714285714286,28.571428571428573,37.547189689711274,469.3856651491478,431.83847545943655,69.73719154002414,89.5338050205613,86.76370057344947
1581724800,10371.33,10400,9750,9911.22,12323.30307,11359.647951000006,12323.30307,11359.647951000006,58.2668419714899,1263340.317539999,2708065.158045797,2708065.158045797,1263340.317539999,42.0573541304501,85.71428571428571,21.428571428571427,-0.04799755334772726,431.77847851775186,431.8264760710996,58.2668419714899,57.68037882668952,75.80433749175008
1581811200,9911.22,10048.34,9612.12,9921,9430.34319,11353.734072500007,9430.34319,11353.734072500007,58.42338121598493,1272770.660729999,2711989.7477086107,2711989.7477086107,1272770.660729999,39.692490433344105,78.57142857142857,14.285714285714286,-26.922159268215637,398.17377698583005,425.0959362540457,58.42338121598493,58.35744845824738,68.52387743516609
1581897600,9920.52,9969.38,9467,9700,10144.64242,10982.038481000007,10144.64242,10982.038481000007,53.53651775238243,1262626.018309999,2711255.1203523474,2711255.1203523474,1262626.018309999,36.95420228590672,71.42857142857143,7.142857142857143,-60.334281327328426,349.67808459488515,410.0123659222136,53.53651775238243,43.05761322570375,53.031813503546914
1581984000,9700,10298.25,9610.27,10188.04,11606.57571,10950.714016500007,11606.57571,10950.714016500007,61.24574337644037,1274232.594019999,2719143.0975304157,2719143.0975304157,1274232.594019999,35.43570390427356,64.28571428571429,0,-50.705961234829715,346.6299143786764,397.3358756135061,61.24574337644037,75.63077864642158,59.01528011012427
1582070400,10188.04,10315,9280.98,9600.08,16637.06446,11135.146682000008,16637.06446,11135.146682000008,50.39697336620187,1257595.529559999,2712774.475207291,2712774.475207291,1257595.529559999,32.90588767513747,57.142857142857146,0,-83.15769540831417,293.3887563531134,376.5464517614276,50.39697336620187,25.702157821397808,48.130183231174406
1582156800,9593.48,9698.1,9393.39,9610.05,12382.02439,11268.294120000008,12382.02439,11268.294120000008,50.55690790988351,1269977.553949999,2718000.598920979,2718000.598920979,1269977.553949999,30.55677260522539,50,92.85714285714286,-101.93518990486797,249.12746438034264,351.0626542852106,50.55690790988351,26.505199229982324,42.61271189926727
1582243200,9610.05,9769.66,9566.98,9695.66,7073.38062,11402.591437500008,7073.38062,11402.591437500008,51.988417116037404,1277050.9345699989,2719908.8900809437,2719908.8900809437,1277050.9345699989,28.611290534925228,42.857142857142854,85.71428571428571,-106.09808958778672,218.44004230047722,324.53813188826393,51.988417116037404,33.40072330108818,28.536026784156135
1582329600,9695.66,9722.97,9575.01,9668.23,3301.25802,11202.25747600001,3301.25802,11202.25747600001,51.474179374296995,1273749.6765499988,2720767.4492091513,2720767.4492091513,1273749.6765499988,26.804771469646504,35.714285714285715,78.57142857142857,-107.85474800336908,189.7196968840526,297.5744448874217,51.474179374296995,31.19135260525318,30.36575837877459
1582416000,9668.23,10025.66,9667.13,9965.01,5631.95146,10888.340037000009,5631.95146,10888.340037000009,56.48894326865544,1279381.6280099987,2724493.965385917,2724493.965385917,1279381.6280099987,26.090058065864508,28.571428571428573,71.42857142857143,-87.07498649854142,188.73071176424492,275.80569826278634,56.48894326865544,55.09572865738244,39.89593485457463
1582502400,9965,10030,9474.74,9660,11274.8465,11042.53732400001,11274.8465,11042.53732400001,50.6910164104431,1268106.7815099987,2720742.722468347,2720742.722468347,1268106.7815099987,24.699606562050345,21.428571428571427,64.28571428571429,-91.46551342676429,161.47380647933096,252.93931990609525,50.6910164104431,30.528460850724528,38.938514037786746
1582588800,9660,9681.56,9230,9305,9370.82104,10847.814628000011,9370.82104,10847.814628000011,44.912981916250544,1258735.9604699987,2714484.7173464973,2714484.7173464973,1258735.9604699987,23.27424545061378,14.285714285714286,100,-114.38390744629663,109.95943559822445,224.34334304452108,44.912981916250544,5.802663035489086,30.475617514532047
1582675200,9304.99,9375.36,8602,8778.3,21610.47728,11294.73039700001,21610.47728,11294.73039700001,37.993439296343794,1237125.4831899987,2702727.160167004,2702727.160167004,1237125.4831899987,23.499141090697865,7.142857142857143,100,-158.41057834381132,26.330120114756937,184.74069845856826,37.993439296343794,9.179853268142278,15.170325718118661
1582761600,8778.3,8972.92,8520,8812.49,14781.0347,11607.94816300001,14781.0347,11607.94816300001,38.65414971413784,1251906.5178899986,2707036.9354970446,2707036.9354970446,1251906.5178899986,23.870942827536147,0,100,-177.20381820419394,-36.76407429667415,140.43974390751978,38.65414971413784,15.557978723404243,10.1801650090119
1582848000,8814.9,8899.94,8428.8,8708.89,13643.30019,11885.06390000001,13643.30019,11885.06390000001,37.355264811370496,1238263.2176999985,2709615.3611219493,2709615.3611219493,1238263.2176999985,24.39855803148785,7.142857142857143,100,-187.58561220656242,-94.04227135068322,93.54334085587918,37.355264811370496,14.209111201298704,12.982314397615104
1582934400,8708.61,8799,8520.67,8525.07,5142.72267,11659.711845000009,5142.72267,11659.711845000009,35.101454570907705,1233120.4950299985,2704635.2366608954,2704635.2366608954,1233120.4950299985,24.888486435157287,0,92.85714285714286,-196.84295154177448,-152.5103485713389,44.33260297043556,35.101454570907705,5.103912628565391,11.623667517756141
1583020800,8523.33,8752.34,8400,8522.31,7353.15375,11364.88945250001,7353.15375,11364.88945250001,35.06724338258779,1225767.3412799984,2702387.1759185726,2702387.1759185726,1225767.3412799984,25.599194761176285,21.428571428571427,100,-192.906748336314,-196.80083244995694,-3.894084113642947,35.06724338258779,6.386945169712767,8.566656333192315
1583107200,8522.3,8973.45,8487.33,8915,10216.70685,11039.62078600001,10216.70685,11039.62078600001,43.50418032615875,1235984.0481299984,2710147.0140308845,2710147.0140308845,1235984.0481299984,25.361405627090665,14.285714285714286,92.85714285714286,-155.23106188687365,-197.932911472235,-42.70184958536136,43.50418032615875,26.89295039164491,12.794602729974384
1583193600,8919.21,8927.45,8635.31,8757.84,9152.72129,10810.206887500008,9152.72129,10810.206887500008,41.19709117512577,1226831.3268399984,2708672.0016452707,2708672.0016452707,1226831.3268399984,25.140601431154014,7.142857142857143,85.71428571428571,-133.11948218240536,-209.10120231336805,-75.9817201309627,41.19709117512577,18.686161879895568,17.322019147084443
1583280000,8757.83,8847,8670.57,8760.66,5688.59949,10239.571878000008,5688.59949,10239.571878000008,41.257288770752574,1232519.9263299983,2708792.9121938595,2708792.9121938595,1232519.9263299983,24.935568963498554,0,78.57142857142857,-111.40935251984682,-215.24341078077123,-103.83405826092441,41.257288770752574,22.12638036809815,22.568497546546237
1583366400,8759.99,9174.24,8759.99,9070.17,10073.3286,10341.91278500001,10073.3286,10341.91278500001,47.59800629763083,1242593.2549299982,2713804.8947110497,2713804.8947110497,1242593.2549299982,23.46158423899594,28.571428571428573,71.42857142857143,-71.26276107094817,-192.91250959960962,-121.64974852866145,47.59800629763083,41.11472392638037,27.30908872479139
1583452800,9070.18,9182.08,9000.01,9158.51,6422.14322,10046.85479250001,6422.14322,10046.85479250001,49.280774980546454,1249015.3981499982,2718564.2717895065,2718564.2717895065,1249015.3981499982,22.064740357317966,21.428571428571427,64.28571428571429,-35.61723366993712,-166.17129061608284,-130.55405694614572,49.280774980546454,46.534355828220875,36.591820040899826
1583539200,9158.51,9214.67,8850.47,8901.37,6478.26772,9899.251019000008,6478.26772,9899.251019000008,44.773683591125895,1242537.1304299983,2713896.788402005,2713896.788402005,1242537.1304299983,21.261942320800316,14.285714285714286,57.142857142857146,-26.628031077411094,-163.83909579290957,-137.21106471549848,44.773683591125895,30.75889570552152,39.469325153374285
1583625600,8901.36,8901.37,8002.2,8037.76,16591.92844,10221.615320000008,16591.92844,10221.615320000008,33.64445545065554,1225945.2019899983,2698617.2012886205,2698617.2012886205,1225945.2019899983,22.462458235573326,7.142857142857143,100,-73.46053321624362,-229.03673123580302,-155.5761980195594,33.64445545065554,1.753624617812427,26.348958717184967
1583712000,8037.73,8187.03,7630,7934.52,25563.62851,10919.467960000009,25563.62851,10919.467960000009,32.60119962820815,1200381.5734799984,2701004.082280318,2701004.082280318,1200381.5734799984,24.13526483478789,0,100,-104.13349283362692,-285.74306406159303,-181.60957122796611,32.60119962820815,14.843338727602434,15.785286350312155
1583798400,7934.56,8158.25,7733.56,7894.68,17172.48576,10946.23902500001,17172.48576,10946.23902500001,32.18643076125126,1183209.0877199983,2696861.481404121,2696861.481404121,1183209.0877199983,25.688585248344264,0,92.85714285714286,-118.78665585287641,-330.0928910440616,-211.3062351911852,32.18643076125126,15.164779758903618,10.587247701439521
1583884800,7894.68,7987.97,7583.27,7938.05,13647.87949,11009.531780000008,13647.87949,11009.531780000008,33.183015464607664,1196856.9672099983,2707142.4118249794,2707142.4118249794,1196856.9672099983,27.346579404471267,0,100,-117.04977107774732,-357.61844903836936,-240.56867796062204,33.183015464607664,21.74696579624861,17.251694760918248
1583971200,7938.05,7969.45,4644,4857.1,113902.21767,16350.973632500009,113902.21767,16350.973632500009,15.620771520315927,1082954.7495399984,2607838.2561228196,2607838.2561228196,1082954.7495399984,30.857839867245,64.28571428571429,100,-304.2509955568553,-620.8824224066911,-316.63142684983586,15.620771520315927,4.662336156405962,13.858027237186091
1584057600,4857.1,5995,3858,5637.6,130316.66133,22701.74379800001,130316.66133,22701.74379800001,26.267068943823432,1213271.4108699984,2694565.6102377125,2694565.6102377125,1213271.4108699984,34.34423188571737,57.142857142857146,100,-352.93940154328993,-757.8056787789483,-404.86627723565834,26.267068943823432,33.22213240688712,19.877144786513924
1584144000,5630.93,5669,5050,5165.25,32760.13734,24058.15309200001,32760.13734,24058.15309200001,24.2712086252821,1180511.2735299985,2674004.522424158,2674004.522424158,1180511.2735299985,37.58159590287028,50,92.85714285714286,-391.4078694676915,-894.1261140702727,-502.7182446025812,24.2712086252821,24.404154073332872,20.762874212208676
1584230400,5161.16,5985,5085.91,5345.35,43763.77684,25682.59960900001,43763.77684,25682.59960900001,26.562451753405284,1224275.0503699984,2655497.5591698275,2655497.5591698275,1224275.0503699984,39.8297377031878,42.857142857142854,85.71428571428571,-378.92416508716315,-976.3734509615351,-597.449285874372,26.562451753405284,27.766317506958618,28.464201329059563
1584316800,5346.86,5350.3,4432.3,5037.61,80184.05147,29223.261130500014,80184.05147,29223.261130500014,25.16156594395727,1144090.9988999984,2681056.8806743496,2681056.8806743496,1144090.9988999984,42.17428402055913,35.714285714285715,78.57142857142857,-365.42820692158455,-1054.2345445263527,-688.8063376047681,25.16156594395727,22.021330416098056,24.73060066546321
1584403200,5039.95,5569.44,4935.6,5331.71,44347.16921,30360.095727000014,44347.16921,30360.095727000014,29.01457073344875,1188438.1681099983,2692138.075706976,2692138.075706976,1188438.1681099983,43.854506664865404,28.571428571428573,71.42857142857143,-312.76436052808083,-1079.7617882648692,-766.9974277367884,29.01457073344875,27.51168169777119,25.76644320694265
1584489600,5331.71,5452.82,5001,5413.64,37513.0496,31496.696472000018,37513.0496,31496.696472000018,30.094312698644515,1225951.2177099984,2723145.165927896,2723145.165927896,1225951.2177099984,45.41471340600695,21.428571428571427,64.28571428571429,-251.13890694105714,-1080.9210614131098,-829.7821544720526,30.094312698644515,29.041176701196832,26.19139627168872
1584576000,5413.88,6441.37,5261.69,6186.26,54666.68909,33547.86591700002,54666.68909,33547.86591700002,39.44807625964715,1280617.9067999984,2754168.122728207,2754168.122728207,1280617.9067999984,44.80307354299623,14.285714285714286,57.142857142857146,-142.47638109726472,-1007.8776308436336,-865.4012497463689,39.44807625964715,43.46468981662115,33.33918273852975
1584662400,6183.82,6990,5657,6206.1,53024.41545,35941.95055600001,53024.41545,35941.95055600001,39.6713091508662,1333642.3222499983,2744828.188183826,2744828.188183826,1333642.3222499983,43.313899010425494,7.142857142857143,50,-57.7441272596227,-937.5814088208972,-879.8372815612745,39.6713091508662,43.83506917543922,38.78031189775243
1584748800,6210.47,6470,5851,6198.78,23514.98094,36750.04191550001,23514.98094,36750.04191550001,39.61328281199249,1310127.3413099984,2747736.600042899,2747736.600042899,1310127.3413099984,41.9310940873241,0,42.857142857142854,5.945613728566059,-872.4052644005669,-878.350878129133,39.61328281199249,46.41301352072125,44.57092417092724
1584835200,6198.64,6420,5738,5818.25,28089.50147,37643.681646500016,28089.50147,37643.681646500016,36.61501541498507,1282037.8398399984,2726257.6044173785,2726257.6044173785,1282037.8398399984,40.76664883434676,0,35.714285714285715,29.27665228927583,-841.7550627675382,-871.031715056814,36.61501541498507,45.28150648066657,45.17652972560904
1584921600,5815.24,6641.03,5678.2,6490.63,42437.98514,39307.94483900002,42437.98514,39307.94483900002,44.59479126420675,1324475.8249799984,2755437.438139047,2755437.438139047,1324475.8249799984,39.28766207436048,0,28.571428571428573,93.21611545000314,-754.5115707443101,-847.7276861943133,44.59479126420675,61.22039416313005,50.97163805483931
1585008000,6493.58,6866.1,6403.16,6766.64,40618.21316,41054.425522500016,40618.21316,41054.425522500016,47.51576650508345,1365094.0381399984,2778602.4717038786,2778602.4717038786,1365094.0381399984,37.51682818102354,0,21.428571428571427,153.7484743300654,-655.5420932817315,-809.2905676117969,47.51576650508345,70.4276302249169,58.976510289571195
1585094400,6766,6983.31,6470,6690.96,31266.38287,42114.078236000016,31266.38287,42114.078236000016,46.78740459755958,1333827.6552699984,2774254.013514696,2774254.013514696,1333827.6552699984,35.66527718650632,0,14.285714285714286,186.17766191496025,-576.5684902180965,-762.7461521330567,46.78740459755958,68.9041579004974,66.8507274295148
1585180800,6691.71,6795,6520.13,6758.18,17456.13147,42665.777648500014,17456.13147,42665.777648500014,47.556365633267994,1351283.7867399983,2787033.499583413,2787033.499583413,1351283.7867399983,33.94597983445461,0,7.142857142857143,207.98754218922682,-502.7617243965233,-710.7492665857501,47.556365633267994,92.59833971902937,77.31004261481458
1585267200,6760,6880,6260,6372.36,20458.27001,43364.77776300001,20458.27001,43364.77776300001,43.65682910471938,1330825.5167299982,2773990.3625357472,2773990.3625357472,1330825.5167299982,32.73607483180093,50,0,192.61213631210796,-469.98409619561517,-662.5962325077231,43.65682910471938,75.85174179927277,79.11807980626655
1585353600,6372.36,6372.36,6030,6251.82,20353.88909,43552.87579550001,20353.88909,43552.87579550001,42.484719500592945,1310471.6276399982,2780011.6322139665,2780011.6322139665,1310471.6276399982,31.93912306340203,42.857142857142854,14.285714285714286,171.2262654942043,-448.56340063996777,-619.7896661341721,42.484719500592945,71.1389138679282,79.8629984620768
1585440000,6251.45,6279.96,5870.46,5877.21,16111.25073,43080.25690650001,16111.25073,43080.25690650001,38.981943346789876,1294360.3769099982,2764431.5216179225,2764431.5216179225,1294360.3769099982,31.42047380849305,35.714285714285715,7.142857142857143,130.58982123949545,-456.55238958480277,-587.1422108242982,38.981943346789876,56.49255190209955,67.82773585643353
1585526400,5878.98,6631.23,5853,6406.4,23659.81678,43404.62345750001,23659.81678,43404.62345750001,45.782383128722955,1318020.1936899982,2774420.73560274,2774420.73560274,1318020.1936899982,30.175837426294404,28.571428571428573,0,137.39848399674634,-415.39410582836535,-552.7925898251117,45.782383128722955,71.59267912772584,66.40804829925122
1585612800,6406.4,6524.79,6333.91,6424.35,11939.0397,43319.18146800001,11939.0397,43319.18146800001,46.00221571763721,1329959.2333899983,2773795.2620224804,2773795.2620224804,1329959.2333899983,29.020103642824235,21.428571428571427,0,140.64859792408402,-376.9818424200066,-517.6304403440906,46.00221571763721,71.56108597285069,66.5487723342254
1585699200,6424.02,6744.99,6160,6666.11,17900.2654,38519.083854500015,17900.2654,38519.083854500015,49.001474553097744,1347859.4987899982,2786868.1870072526,2786868.1870072526,1347859.4987899982,27.469454990737464,14.285714285714286,0,155.46037077682467,-323.3049768730598,-478.76534764988446,49.001474553097744,81.25972771088519,74.80449760382061
1585785600,6666.11,7292.11,6570.92,6804.52,28761.02219,33441.301897500016,28761.02219,33441.301897500016,50.690124453651634,1376620.5209799982,2776739.078137138,2776739.078137138,1376620.5209799982,26.02470264082567,100,0,169.79242866226411,-266.5248118220543,-436.3172404843184,50.690124453651634,70.17998789072298,74.33360052481966
1585872000,6804.24,7050,6606.06,6741.99,14953.19743,32550.954902000016,14953.19743,32550.954902000016,49.8864680674132,1361667.3235499982,2770942.920517292,2770942.920517292,1361667.3235499982,24.68314688733615,92.85714285714286,0,169.86198768494387,-223.98975587813857,-393.85174356308244,49.8864680674132,65.91383658320477,72.45118406160434
1585958400,6741.99,7025.53,6658.16,6874.77,10217.69354,30873.650737000018,10217.69354,30873.650737000018,51.63979963951742,1371885.0170899981,2772774.412254802,2772774.412254802,1371885.0170899981,23.43741654481017,85.71428571428571,14.285714285714286,173.0655204228027,-177.51984303457903,-350.58536345738173,51.63979963951742,74.14106114963045,70.07829520785276
1586044800,6874.77,6925,6681,6778.25,8962.92484,27312.594405500022,8962.92484,27312.594405500022,50.26313565237456,1362922.0922499981,2770956.1139778346,2770956.1139778346,1362922.0922499981,22.28066694103604,78.57142857142857,7.142857142857143,163.03759104848098,-146.78837464678054,-309.8259656952615,50.26313565237456,68.16055418207957,69.40515063830496
1586131200,6778.64,7373.37,6773.28,7341.56,27992.02748,26494.83731900002,27992.02748,26494.83731900002,57.4008500603162,1390914.119729998,2795980.498623797,2795980.498623797,1390914.119729998,22.068211762909577,100,0,186.9793316541277,-76.1018011276019,-263.0811327817296,57.4008500603162,97.90774614074208,80.06978715748407
1586217600,7341.55,7466,7073,7200.01,22743.08039,25756.338858500018,22743.08039,25756.338858500018,55.254999657655304,1368171.039339998,2787937.665767303,2787937.665767303,1368171.039339998,22.033017846514195,100,42.857142857142854,185.54885545956313,-31.145063457275683,-216.6939189168388,55.254999657655304,83.50960942343461,83.19263658208546
1586304000,7200.01,7430,7154.22,7370.11,15429.13633,23794.46122050002,15429.13633,23794.46122050002,57.31983910815378,1383600.175669998,2796665.4388744175,2796665.4388744175,1383600.175669998,22.00033778128991,92.85714285714286,35.714285714285715,187.75642479652524,18.001612078817743,-169.7548127177075,57.31983910815378,94.05517668939862,91.82417741785848
1586390400,7370.38,7377,7110,7293.24,12369.8572,21761.73330800002,12369.8572,21761.73330800002,56.06080256634455,1371230.318469998,2801274.253085114,2801274.253085114,1371230.318469998,21.836861227926445,85.71428571428571,28.571428571428573,175.9395428551358,50.16961585121226,-125.76992700392354,56.06080256634455,89.28952262864226,88.95143624715854
1586476800,7293.23,7305.91,6750,6871.91,19671.20459,21569.544490500022,19671.20459,21569.544490500022,49.626556058876396,1351559.113879998,2790230.763598519,2790230.763598519,1351559.113879998,20.671925890751975,78.57142857142857,21.428571428571427,133.5682327433756,41.19036392529597,-92.37786881807963,49.626556058876396,63.16862988220706,82.17110973341602
1586563200,6871.83,6955,6775,6889.65,8066.08984,20568.37390900002,8066.08984,20568.37390900002,49.88735249228964,1359625.203719998,2792439.9759824746,2792439.9759824746,1359625.203719998,19.59020022051854,71.42857142857143,14.285714285714286,101.9831657153209,35.101088326071476,-66.88207738924942,49.88735249228964,64.26844389336638,72.24219880140528
1586649600,6889.78,7200,6787.44,6908.13,12734.00273,19083.17478850002,12734.00273,19083.17478850002,50.17673032764396,1372359.206449998,2787156.364902095,2787156.364902095,1372359.206449998,19.162829404692303,64.28571428571429,7.142857142857143,78.62923310082408,31.404463986780684,-47.2247691140434,50.17673032764396,65.41413515189089,64.28373630915482
1586736000,6908.12,6908.13,6555,6861.21,22323.78115,18168.45318800002,22323.78115,18168.45318800002,49.39679709474204,1350035.4252999981,2803547.8728860766,2803547.8728860766,1350035.4252999981,18.113916967611207,57.142857142857146,0,57.305780670397965,24.407456723954056,-32.89832394644391,49.39679709474204,53.691424196018374,61.12466774709193
1586822400,6860.51,6997.38,6771.41,6877.37,12868.62054,17248.56507150002,12868.62054,17248.56507150002,49.68686819072534,1362904.0458399982,2802747.748451032,2802747.748451032,1362904.0458399982,17.35934728009919,50,7.142857142857143,42.26781126184993,19.936440130868505,-22.331371130981424,49.68686819072534,54.928790199081156,58.011449848996854
1586908800,6876.92,6940,6605.89,6624.12,14753.82802,17113.44989900002,14753.82802,17113.44989900002,45.3040242070126,1348150.2178199983,2789603.942787769,2789603.942787769,1348150.2178199983,16.19504057667447,42.857142857142854,0,14.668322345953754,-3.995968198539231,-18.664290544492985,45.3040242070126,7.587266739846311,38.735827044981995
1586995200,6623.62,7217.27,6456,7112.64,28117.57147,17496.41497200002,28117.57147,17496.41497200002,53.7745952294413,1376267.7892899984,2809992.4785597743,2809992.4785597743,1376267.7892899984,15.807797495788625,35.714285714285715,100,27.946923591194853,16.269363944500583,-11.67755964669427,53.7745952294413,65.01386138613864,42.509972775022085
1587081600,7114.76,7156.66,7000,7037.46,13514.59082,17154.45005850002,13514.59082,17154.45005850002,52.428942284848425,1362753.1984699983,2802941.0126231806,2802941.0126231806,1362753.1984699983,15.448214634966057,28.571428571428573,92.85714285714286,30.113319804142627,25.964090108484015,-4.1492296956586125,52.428942284848425,57.57029702970297,43.390475051896026
1587168000,7036.45,7308,7021,7261.76,11510.53562,16924.41430300002,11510.53562,16924.41430300002,55.96911889078785,1374263.7340899983,2810742.508751412,2810742.508751412,1374263.7340899983,15.487262362276402,21.428571428571427,85.71428571428571,44.24471472573286,51.15666371150746,6.911948985774603,55.96911889078785,79.7782178217822,67.45412541254132
1587254400,7262.04,7275,7063.02,7130.71,8887.90304,16185.818616000022,8887.90304,16185.818616000022,53.4656103127722,1365375.8310499983,2807530.821927825,2807530.821927825,1365375.8310499983,15.523520966207439,14.285714285714286,78.57142857142857,42.3562984722916,59.8573220761391,17.501023603847504,53.4656103127722,66.8029702970297,68.050495049505
1587340800,7130.7,7227.11,6748.72,6838.19,18396.61987,16508.69762450002,18396.61987,16508.69762450002,48.27491697098741,1346979.2111799982,2796015.3892890336,2796015.3892890336,1346979.2111799982,14.53368907832532,7.142857142857143,71.42857142857143,20.124792081465735,42.657013705679674,22.53222162421394,48.27491697098741,37.840594059405895,61.47392739273931
1587427200,6837.22,6959,6776,6853.68,14467.8568,16337.077194500022,14467.8568,16337.077194500022,48.55971354346373,1361447.0679799982,2793830.189496946,2793830.189496946,1361447.0679799982,13.614559468149064,0,64.28571428571429,5.918653365004097,29.930538330469062,24.011884965464965,48.55971354346373,40.82956878850106,48.4910443816456
1587513600,6853.67,7167.37,6826,7136.84,13141.15528,15556.083849000022,13141.15528,15556.083849000022,53.590183737476096,1374588.2232599983,2804620.8191261953,2804620.8191261953,1374588.2232599983,13.370348132607413,0,57.142857142857146,14.55595316150761,42.206826417349475,27.650873255841866,53.590183737476096,73.92399565689469,50.8647195016006
1587600000,7136.81,7775,7031.14,7488.83,22759.37919,15946.392937000022,22759.37919,15946.392937000022,58.96258347442352,1397347.6024499983,2809868.700069745,2809868.700069745,1397347.6024499983,14.51687213814985,100,50,41.41768997814757,79.42298572852633,38.00529575037876,58.96258347442352,78.30401819560272,64.35252754699955
1587686400,7491.5,7612.24,7390,7514.64,13764.58148,16123.737334000023,13764.58148,16123.737334000023,59.33431460207967,1411112.1839299982,2811543.440365008,2811543.440365008,1411112.1839299982,15.581501571867824,92.85714285714286,42.857142857142854,57.38356934470485,109.73475743125982,52.35118808655497,59.33431460207967,80.26080363912057,77.49627249720605
1587772800,7514.99,7720,7437.94,7547.61,7443.81054,16047.781619000021,7443.81054,16047.781619000021,59.83482625448831,1418555.9944699982,2809888.2046099603,2809888.2046099603,1418555.9944699982,16.782708863367848,85.71428571428571,35.714285714285715,66.00932428152257,134.86284343845819,68.85351915693562,59.83482625448831,82.76042456406367,80.4417487995957
1587859200,7547.61,7715,7490,7706.4,9292.65513,15112.813001500024,9292.65513,15112.813001500024,62.24500576176823,1427848.6495999983,2818470.487881134,2818470.487881134,1427848.6495999983,17.898115634046444,78.57142857142857,28.571428571428573,77.4613449596354,165.68020035647987,88.21885539684448,62.24500576176823,94.79909021986352,85.94010614101597
1587945600,7706.4,7810.99,7635.69,7789.77,15455.75061,14748.446512500022,15455.75061,14748.446512500022,63.48395857677173,1443304.4002099982,2830184.412730219,2830184.412730219,1443304.4002099982,19.135460003725242,100,21.428571428571427,85.09480212390187,194.58735805172182,109.49255592781995,63.48395857677173,98.43393678182133,91.99781718858289
1588032000,7789.77,7794.74,7672,7755.01,10984.78073,14526.228732500022,10984.78073,14526.228732500022,62.56213759875924,1432319.6194799982,2834057.81431075,2834057.81431075,1432319.6194799982,20.2844226327127,92.85714285714286,14.285714285714286,82.20197032358845,212.2450188323055,130.04304850871705,62.56213759875924,95.86860419634097,96.367210399342
1588118400,7757.18,8988,7720,8793.75,48689.76446,16342.22409550002,48689.76446,16342.22409550002,74.48517587392803,1481009.3839399982,2867829.6186029976,2867829.6186029976,1481009.3839399982,23.089990570203494,100,7.142857142857143,141.184018741677,306.5230719358133,165.33905319413628,74.48517587392803,92.3281990521327,95.54358001009838
1588204800,8794.99,9478.66,8407,8624.28,44844.03802,17600.865767000018,44844.03802,17600.865767000018,70.53814446338656,1436165.3459199981,2841169.916251,2841169.916251,1436165.3459199981,26.107214247918222,100,0,158.42918038529865,363.3755286757596,204.94634829046095,70.53814446338656,68.7033414653802,85.63338157128469
1588291200,8624.68,9075.98,8622.72,8829.42,21660.23418,18280.57298400002,21660.23418,18280.57298400002,72.44182222860314,1457825.580099998,2839265.100175426,2839265.100175426,1457825.580099998,28.908921948653322,92.85714285714286,21.428571428571427,172.15609300062005,420.141464541236,247.98537154061597,72.44182222860314,76.21779233243221,79.08311094998176
1588377600,8829.42,9025,8762.01,8985.58,10539.27959,18170.83682700002,10539.27959,18170.83682700002,73.82816810924379,1468364.859689998,2846644.8801537463,2846644.8801537463,1468364.859689998,31.510507670764493,85.71428571428571,14.285714285714286,179.44008010953564,472.2854716775355,292.84539156799985,73.82816810924379,81.93806457284775,75.6197327902201
1588464000,8984.69,9203.52,8731.01,8909.95,17147.66806,17912.03117250002,17147.66806,17912.03117250002,71.94059361865217,1451217.191629998,2842484.8894874793,2842484.8894874793,1451217.191629998,34.07702679931718,78.57142857142857,7.142857142857143,167.10265115491592,501.72370551164477,334.62105435672885,71.94059361865217,79.16767401481354,79.10784364003122
1588550400,8907.85,8970,8533.98,8883.53,18380.64102,18187.63219650002,18380.64102,18187.63219650002,71.25522827653961,1432836.550609998,2853575.1583731766,2853575.1583731766,1432836.550609998,35.65317044266206,71.42857142857143,0,145.87325364719993,516.9626214157288,371.08936776852886,71.25522827653961,77.97984208150491,79.69519355638879
1588636800,8887.81,9126.27,8769.69,9028.79,16392.3138,18269.55648550002,16392.3138,18269.55648550002,72.79010298512623,1449228.8644099978,2861004.9798896834,2861004.9798896834,1449228.8644099978,37.28744607444934,64.28571428571429,0,130.80716448575993,534.5983233757288,403.79115888996887,72.79010298512623,83.04079678511384,80.0627709604775
1588723200,9028.78,9418,8922.13,9155.79,27650.893,18246.222562000017,27650.893,18246.222562000017,74.09261006365037,1476879.7574099978,2859412.9638468698,2859412.9638468698,1476879.7574099978,39.097451353411905,57.142857142857146,0,118.93046035327342,552.4542343315607,433.52377397828724,74.09261006365037,86.80827940118982,82.60963942260292
1588809600,9155.79,10079,9028.89,10004.77,39447.58966,19542.87250400002,39447.58966,19542.87250400002,80.73245569029629,1516327.3470699978,2893283.6242700056,2893283.6242700056,1516327.3470699978,41.29646545459596,100,0,155.47940777100132,627.8730336920389,472.3936259210376,80.73245569029629,97.2394942357754,89.0295234740264
1588896000,10000.37,10049,9730,9810,26363.73142,20285.532294000022,26363.73142,20285.532294000022,75.9248634211991,1489963.6156499977,2880143.0810230463,2880143.0810230463,1489963.6156499977,43.338407119981156,92.85714285714286,0,153.50060357147532,664.2693803853817,510.7687768139064,75.9248634211991,89.81469561463958,91.28748975053497
1588982400,9810.01,9920.73,9521,9537.21,17931.18914,20737.69659900002,17931.18914,20737.69659900002,69.66737602418468,1472032.4265099978,2863666.1964184046,2863666.1964184046,1472032.4265099978,44.42796477241204,85.71428571428571,0,122.14817019422287,663.453989556685,541.3058193624621,69.66737602418468,79.0733874082657,88.70919241956028
1589068800,9537.21,9559.98,8106.7,8729.86,50909.85883,22363.358547000018,50909.85883,22363.358547000018,55.17402743330186,1421122.5676799978,2856416.179640181,2856416.179640181,1421122.5676799978,41.74321094070621,78.57142857142857,0,39.63569071693189,590.850432758627,551.2147420416951,55.17402743330186,44.78228305045209,71.22345535778582
1589155200,8729.86,9182.66,8185,8572.4,39999.39171,23639.93529250002,39999.39171,23639.93529250002,52.86412613545069,1381123.1759699977,2847481.006899477,2847481.006899477,1381123.1759699977,39.25022523983652,71.42857142857143,0,-29.233350219618387,514.6730542671721,543.9064044867905,52.86412613545069,37.407561279601154,53.754410579439686
1589241600,8572.4,8982.9,8534.85,8821.42,20219.33065,23993.844061000018,20219.33065,23993.844061000018,56.00135838009572,1401342.5066199976,2853125.9931086246,2853125.9931086246,1401342.5066199976,36.9353099461718,64.28571428571429,0,-59.933486562518056,468.989546283643,528.923032846161,56.00135838009572,46.690122933446375,42.95998908783324
1589328000,8821.41,9420.18,8803.97,9321.26,21357.64441,23923.75732200002,21357.64441,23923.75732200002,61.535348411389705,1422700.1510299975,2867626.5654651453,2867626.5654651453,1422700.1510299975,35.53040863315315,57.142857142857146,0,-48.95739410609474,467.7262902135426,516.6836843196373,61.535348411389705,61.58089540130813,48.5595265381186
1589414400,9320.85,9943.93,9257.15,9795.34,28752.37466,24673.14698100002,28752.37466,24673.14698100002,65.91435796124408,1451452.5256899975,2883937.3566465075,2883937.3566465075,1451452.5256899975,34.9712889979202,50,71.42857142857143,-13.967192960388957,499.2246931191512,513.1918860795402,65.91435796124408,85.6178066217107,64.62960831882178
1589500800,9795.34,9849,9120,9312.1,25180.99401,25560.006154500024,25180.99401,25560.006154500024,58.592039254094374,1426271.5316799975,2872027.333690886,2872027.333690886,1426271.5316799975,34.138775289244734,42.857142857142854,64.28571428571429,-26.82174974935822,479.66469889284235,506.48644864220057,58.592039254094374,61.116463012726285,69.43838834524841
1589587200,9312.1,9594.99,9215.01,9383.16,10782.34207,25634.490501500026,10782.34207,25634.490501500026,59.30789541099418,1437053.8737499975,2870787.866609414,2870787.866609414,1437053.8737499975,33.36572684547466,35.714285714285715,57.142857142857146,-33.55535354947307,464.54225670535925,498.0976102548323,59.30789541099418,64.7193631800436,70.48454427149356
1589673600,9380.01,9896,9325.81,9676.63,13540.67725,25538.73683350003,13540.67725,25538.73683350003,62.21328422938589,1450594.5509999974,2873909.496284632,2873909.496284632,1450594.5509999974,33.08830776195689,28.571428571428573,50,-21.829309912807616,470.8109728638228,492.64028277663044,62.21328422938589,79.59894539370275,68.47825719549091
1589760000,9677.45,9957.25,9436.97,9728.52,17710.31395,25875.013494500025,17710.31395,25875.013494500025,62.72012690630137,1468304.8649499975,2876047.887001821,2876047.887001821,1468304.8649499975,32.91791705243064,21.428571428571427,42.857142857142854,-14.515133281535157,474.4963661747115,489.01149945624667,62.72012690630137,82.22988389190287,75.51606415521644
1589846400,9728.52,9898,9463.22,9783.76,15229.65048,24202.007795500027,15229.65048,24202.007795500027,63.28471999345852,1483534.5154299976,2883274.2472162372,2883274.2472162372,1483534.5154299976,32.75969710787055,14.285714285714286,35.714285714285715,-10.102778543642728,476.3830262766933,486.485804820336,63.28471999345852,85.03067484662577,82.2865013774105
1589932800,9783.57,9836.99,9294.54,9509.41,16895.56357,22804.584073000027,16895.56357,22804.584073000027,58.542634580634996,1466638.9518599976,2879763.6951469686,2879763.6951469686,1466638.9518599976,32.12354699829428,7.142857142857143,28.571428571428573,-28.751170019098993,450.5468422964623,479.29801231556127,58.542634580634996,71.12051919079246,79.46035930977375
1590019200,9509.4,9568,8800,9061.96,28081.24334,23125.634531000025,28081.24334,23125.634531000025,51.733850748326546,1438557.7085199975,2870839.124997975,2870839.124997975,1438557.7085199975,30.276907203603997,0,21.428571428571427,-71.85731883864071,389.4763637672604,461.3336826059011,51.733850748326546,49.18189775009006,68.44436392916947
1590105600,9059.32,9267.34,8923.5,9168.84,13731.9333,23285.267216500026,13731.9333,23285.267216500026,53.13593419988923,1452289.6418199975,2876703.4720366322,2876703.4720366322,1452289.6418199975,28.562170251391596,0,14.285714285714286,-92.4935976363812,345.7166855604246,438.2102831968058,53.13593419988923,57.39590932425496,59.23277542171254
1590192000,9168.84,9313.83,9090.11,9181.76,6878.86214,22771.826920500025,6878.86214,22771.826920500025,53.31249027811925,1459168.5039599976,2875460.652406296,2875460.652406296,1459168.5039599976,27.071958952948567,64.28571428571429,7.142857142857143,-103.74990545752945,308.522901374894,412.27280683242344,53.31249027811925,58.09408013833727,54.89062907089414
1590278400,9181.09,9306.23,8680.7,8715.73,13004.3601,22503.012874500026,13004.3601,22503.012874500026,46.50648515648532,1446164.1438599976,2863912.7939426783,2863912.7939426783,1446164.1438599976,25.559873510131425,57.142857142857146,0,-138.86595799911908,238.6903593335246,377.5563173326437,46.50648515648532,29.946677951756218,48.47888913811619
1590364800,8715.69,8977,8632.93,8899.31,12328.25644,22299.810006500025,12328.25644,22299.810006500025,49.25472773270339,1458492.4002999975,2870673.6818656693,2870673.6818656693,1458492.4002999975,24.26079233666689,50,0,-145.32289859008966,195.90269409503162,341.2255926851213,49.25472773270339,25.622890888638864,37.887882992910825
1590451200,8900,9016.99,8694.23,8844.42,11507.44544,21492.637628500026,11507.44544,21492.637628500026,48.45318113876101,1446984.9548599976,2869875.761959401,2869875.761959401,1446984.9548599976,22.947988857546388,42.857142857142854,0,-148.36575754321825,155.76839575609847,304.1341532993167,48.45318113876101,15.969705207200663,23.84642468253196
1590537600,8844.41,9230,8811.46,9208.53,10936.69289,20067.092790000028,10936.69289,20067.092790000028,53.8215711777157,1457921.6477499977,2879690.407750685,2879690.407750685,1457921.6477499977,21.446790276504895,35.714285714285715,85.71428571428571,-122.0314678607416,151.59481847338975,273.62628633413135,53.8215711777157,43.4638153920503,28.352137162629987
1590624000,9208.53,9625,9112,9580.19,14511.09092,19474.460765000025,14511.09092,19474.460765000025,58.56514747183943,1472432.7386699978,2891666.4422023604,2891666.4422023604,1472432.7386699978,20.95246370309356,28.571428571428573,78.57142857142857,-77.90467976241388,176.245436631114,254.15011639352787,58.56514747183943,71.52802947927997,43.65385002617702
1590710400,9580.01,9609.02,9330.01,9423.84,10415.44084,19098.673350000026,10415.44084,19098.673350000026,55.960866060149975,1462017.2978299977,2888256.347507783,2888256.347507783,1462017.2978299977,20.493446170640176,21.428571428571427,71.42857142857143,-58.45790165186895,181.07773932869168,239.53564098056063,55.960866060149975,59.72197052072007,58.23793846401682
1590796800,9423.85,9764,9326.43,9700.33,10509.7126,17078.66603850003,10509.7126,17078.66603850003,59.39921045966758,1472527.0104299977,2895707.5624902956,2895707.5624902956,1472527.0104299977,20.404311874869187,14.285714285714286,64.28571428571429,-27.743432923730694,204.85634982589727,232.59978274962796,59.39921045966758,80.59985501993475,70.6166183399783
1590883200,9700.32,9705.6,9369.58,9446.57,7944.73118,15475.933012000029,7944.73118,15475.933012000029,55.14385221527353,1464582.2792499978,2891403.4768287065,2891403.4768287065,1464582.2792499978,20.32154431451041,7.142857142857143,57.142857142857146,-25.35278055567281,200.90880705503696,226.26158761070977,55.14385221527353,61.438323063912016,67.253382868189
1590969600,9445.83,10428,9417.42,10208.96,21676.62263,15548.797611000027,21676.62263,15548.797611000027,63.58457358178774,1486258.901879998,2903683.421470076,2903683.421470076,1486258.901879998,21.57062415208231,100,50,24.065833697440723,256.3438797325107,232.27804603506996,63.58457358178774,87.79769034076661,76.61195614153785
1591056000,10208.96,10237.6,9270,9522.46,33220.60717,16141.94574900003,33220.60717,16141.94574900003,53.772403398731285,1453038.294709998,2887798.230765843,2887798.230765843,1453038.294709998,22.25712318048354,92.85714285714286,42.857142857142854,7.850432125759511,242.09108619226936,234.24065406650985,53.772403398731285,49.55405638777312,66.26335659748396
1591142400,9521.53,9695,9385.22,9668.07,11446.7364,15276.66383600003,11446.7364,15276.66383600003,55.346404691348596,1464485.031109998,2897254.7766354536,2897254.7766354536,1464485.031109998,22.894586563998967,85.71428571428571,35.714285714285715,4.432362638874366,239.7811073651028,235.34874472622843,55.346404691348596,57.66571777145179,65.00582149999723
1591228800,9668.06,9888,9450,9788.03,12441.28756,14639.67851350003,12441.28756,14639.67851350003,56.65578220502456,1476926.318669998,2904016.8152576764,2904016.8152576764,1476926.318669998,23.821008002665835,78.57142857142857,28.571428571428573,7.567568499859988,244.8082053510534,237.24063685119341,56.65578220502456,64.34846551945053,57.18941322622519
1591315200,9791.96,9855,9585.44,9613.21,12495.91227,14725.357023500028,12495.91227,14725.357023500028,54.16318566196535,1464430.406399998,2894095.554150593,2894095.554150593,1464430.406399998,24.681256481427923,71.42857142857143,21.428571428571427,-4.183531240608545,232.01122280043273,236.19475404104128,54.16318566196535,54.60956954324895,58.874584278050484
1591401600,9613.42,9735.13,9526.03,9671.7,6501.33171,14373.389746500028,6501.33171,14373.389746500028,54.87845060784495,1470931.7381099982,2896652.5580713507,2896652.5580713507,1470931.7381099982,25.24989669343643,64.28571428571429,14.285714285714286,-9.750232610999404,224.00696327729202,233.75719588829142,54.87845060784495,57.867938297670875,58.941991120123504
1591488000,9670.28,9822,9370,9750.12,11628.95962,14069.322030000028,11628.95962,14069.322030000028,55.8726875427931,1482560.6977299983,2904582.8910653084,2904582.8910653084,1482560.6977299983,25.182331836310173,57.142857142857146,7.142857142857143,-9.854748418082153,221.43876036568872,231.29350878377087,55.8726875427931,62.236570161609336,58.238026000843114
1591574400,9750.12,9815,9632.79,9781.51,8533.85039,13734.532025500026,8533.85039,13734.532025500026,56.28788706912638,1491094.5481199983,2909979.716598702,2909979.716598702,1491094.5481199983,25.119593040407224,50,0,-9.509077007181247,219.40716252479433,228.91623953197558,56.28788706912638,62.71189373446307,60.93880073124782
1591660800,9781.51,9886,9567.33,9779.41,10329.89137,13406.248415500027,10329.89137,13406.248415500027,56.249755675835026,1480764.6567499982,2913399.242254149,2913399.242254149,1480764.6567499982,25.234948802983176,42.857142857142854,0,-11.014938087443568,215.1475669226711,226.16250501011467,56.249755675835026,59.877887339626625,61.60878374523306
1591747200,9779.7,10018.67,9690,9894.04,12965.4402,12650.458258500028,12965.4402,12650.458258500028,57.925287073388105,1493730.0969499983,2916531.823890082,2916531.823890082,1493730.0969499983,25.65969020259779,35.714285714285715,0,-6.127822967446207,218.5027263008069,224.6305492682531,57.925287073388105,59.42553191489368,60.67177099632784
1591833600,9894.35,9973.25,9050,9268.16,26779.89398,13302.85629250003,26779.89398,13302.85629250003,47.27860658390008,1466950.2029699984,2902407.8772064303,2902407.8772064303,1466950.2029699984,23.845837492499474,28.571428571428573,100,-44.73355655336633,168.7136035765452,213.44716012991154,47.27860658390008,15.831640058055141,45.04501977085854
1591920000,9268.16,9552.87,9227,9464.17,10992.53079,13508.53972500003,10992.53079,13508.53972500003,50.35601074871205,1477942.7337599983,2907416.1966172117,2907416.1966172117,1477942.7337599983,22.161545690265324,21.428571428571427,92.85714285714286,-56.02293222497943,143.41849484868726,199.4414270736667,50.35601074871205,30.055878084179977,35.10435001904299
1592006400,9464.71,9494.45,9346,9475,4581.80627,13087.41203350003,4581.80627,13087.41203350003,50.527838558195214,1482524.5400299984,2910797.381372203,2910797.381372203,1482524.5400299984,20.597560445333617,14.285714285714286,85.71428571428571,-61.28920362512412,122.82992254226156,184.11912616738567,50.527838558195214,30.84179970972424,25.576439283986506
1592092800,9475,9481,9240,9325,4829.81177,12712.48980000003,4829.81177,12712.48980000003,48.047314816703455,1477694.7282599984,2909374.4907677635,2909374.4907677635,1477694.7282599984,19.48186596650215,7.142857142857143,78.57142857142857,-72.62834768513926,93.3336915609616,165.96203924610086,48.047314816703455,19.956458635703918,26.951378809869436
1592179200,9328.63,9499,8895.01,9432.53,18589.3001,13066.58253300003,18589.3001,13066.58253300003,49.94440663662686,1496284.0283599985,2923872.230485482,2923872.230485482,1496284.0283599985,19.41014221737826,0,100,-70.5789363500522,77.7383688085356,148.3173051585878,49.94440663662686,40.036049724785705,30.27810269007134
1592265600,9432.57,9592.04,9381,9526.25,10345.30966,13037.01337150003,10345.30966,13037.01337150003,51.60317055909941,1506629.3380199985,2927767.4082033727,2927767.4082033727,1506629.3380199985,19.008188788304643,0,92.85714285714286,-60.965729666142295,72.11014307590995,133.07587274205224,51.60317055909941,56.17713543242617,38.72321459763865
1592352000,9526.25,9558.48,9227.03,9457.51,8937.94042,12758.35584650003,8937.94042,12758.35584650003,50.28688938320736,1497691.3975999984,2931259.7981982264,2931259.7981982264,1497691.3975999984,19.04117800186846,50,85.71428571428571,-57.34448720590713,61.39526373466833,118.73975094057546,50.28688938320736,50.059626577434464,48.757603911548834
1592438400,9457.51,9482.66,9267.18,9376.14,6300.60167,12552.61388800003,6300.60167,12552.61388800003,48.70320265638515,1491390.7959299984,2931331.1434185477,2931331.1434185477,1491390.7959299984,19.071810843034864,42.857142857142854,78.57142857142857,-58.34404075909475,45.80969999170702,104.15374075080177,48.70320265638515,42.81811224035734,49.68495808340604
1592524800,9376.14,9430,9229,9301.91,7871.97815,12420.727165500031,7871.97815,12420.727165500031,47.24156863775081,1483518.8177799983,2929170.0700139855,2929170.0700139855,1483518.8177799983,19.207344644563566,35.714285714285715,71.42857142857143,-61.59878549452665,27.155258882643466,88.75404437717012,47.24156863775081,36.212021429969894,43.02992008258729
1592611200,9300.42,9391.71,9161,9355.74,6900.62352,12368.52178250003,6900.62352,12368.52178250003,48.44977546512379,1490419.4412999982,2933918.940874678,2933918.940874678,1490419.4412999982,19.527824620038864,28.571428571428573,64.28571428571429,-57.78353515464816,16.52462543385991,74.30816058850807,48.44977546512379,41.00261644981575,40.010916706714376
1592697600,9355.74,9419.35,9273,9286.14,3088.68281,11439.124791500031,3088.68281,11439.124791500031,46.95258029201615,1487330.7584899983,2931384.8913700883,2931384.8913700883,1487330.7584899983,19.694052680330554,21.428571428571427,57.142857142857146,-57.48226447733972,2.4553299918334233,59.93759446917314,46.95258029201615,34.808571987967824,37.341069955917874
1592784000,9286.14,9792,9267.58,9690.74,11775.75302,10366.88208400003,11775.75302,10366.88208400003,55.55151970056314,1499106.5115099982,2938613.0956665264,2938613.0956665264,1499106.5115099982,18.30308155137148,14.285714285714286,50,-29.0059313916138,23.68018022965589,52.68611162126969,55.55151970056314,70.81590516704338,48.8756978682757
1592870400,9690.67,9724.53,9572.22,9623.56,7946.99786,10191.895157000032,7946.99786,10191.895157000032,53.98669332766385,1491159.5136499982,2936023.5775535214,2936023.5775535214,1491159.5136499982,17.011465503052342,7.142857142857143,42.857142857142854,-14.404578516179946,34.680388476044754,49.0849669922247,53.98669332766385,64.83722834309305,56.820568499368136
1592956800,9623.56,9663.38,9195,9285.91,13410.77305,10240.36943150003,13410.77305,10240.36943150003,46.844376468923016,1477748.7405999983,2927818.7201189427,2927818.7201189427,1477748.7405999983,17.04140897785144,0,35.714285714285715,-26.493154063422267,15.968524412946863,42.46167847636913,46.844376468923016,36.25352426175988,57.302219257298816
1593043200,9285.94,9335,8979.07,9243.51,13529.07074,10292.027355000031,13529.07074,10292.027355000031,46.02101160137072,1464219.6698599982,2934392.632923379,2934392.632923379,1464219.6698599982,17.63604592506102,0,28.571428571428573,-35.77420807125874,-2.2560816127042926,33.51812645855445,46.02101160137072,38.852161116623385,46.64763790715882
1593129600,9242.98,9291.73,9027.62,9155.42,10702.38759,10502.08014900003,10702.38759,10502.08014900003,44.27966727573973,1453517.2822699982,2934047.7867668876,2934047.7867668876,1453517.2822699982,18.188208804612774,71.42857142857143,21.428571428571427,-45.64332618487752,-23.53603127254246,22.107294912335064,44.27966727573973,29.03153881314172,34.712408063841714
1593216000,9155.42,9188.14,8815.01,9002.46,8507.28276,10345.99630600003,8507.28276,10345.99630600003,41.35364116339969,1445009.9995099981,2934088.142381513,2934088.142381513,1445009.9995099981,19.22814390462067,64.28571428571429,100,-59.399497486627375,-52.14207694594916,7.257420540678218,41.35364116339969,19.186480926109677,29.023393618624976
1593302400,9002.38,9189,8931.77,9113.24,5537.77192,10196.19238250003,5537.77192,10196.19238250003,44.228108586371626,1450547.771429998,2936363.9184172135,2936363.9184172135,1450547.771429998,20.189714836482896,57.142857142857146,92.85714285714286,-57.904223066002366,-65.12285829182474,-7.218635225822375,44.228108586371626,30.52538920562131,26.24780298162428
1593388800,9113.23,9236.75,9014,9184.45,8658.44113,10112.61987050003,8658.44113,10112.61987050003,46.058335712615936,1459206.212559998,2940956.4877528343,2940956.4877528343,1459206.212559998,20.84468780253505,50,85.71428571428571,-49.321312212228705,-68.87027549110826,-19.548963278879555,46.058335712615936,37.81410249849032,29.175324210073814
1593475200,9188.79,9201,9059.6,9136.2,6820.88175,9805.39194800003,6820.88175,9805.39194800003,44.981221213282566,1452385.330809998,2941525.698535366,2941525.698535366,1452385.330809998,21.452876985297767,42.857142857142854,78.57142857142857,-44.25718339448641,-74.87044252198757,-30.61325912750116,44.981221213282566,32.875464436688254,33.73831871360001
1593561600,9135.91,9297.2,9088,9239.97,7550.17428,8843.90596300003,7550.17428,8843.90596300003,47.808153929894694,1459935.505089998,2944944.931380907,2944944.931380907,1459935.505089998,21.505709299106837,35.714285714285715,71.42857142857143,-31.861596660670116,-70.44025495333881,-38.57865829266869,47.808153929894694,43.49686281333476,38.062143249504494
1593648000,9239.41,9265,8938,9091.53,10774.20016,8832.989431500031,10774.20016,8832.989431500031,44.301545929078735,1449161.304929998,2944287.9358115173,2944287.9358115173,1449161.304929998,22.027798750349284,28.571428571428573,64.28571428571429,-31.543425246047093,-78.00793985022756,-46.464514604180465,44.301545929078735,28.303257965792945,34.891861738605364
1593734400,9091.98,9126.12,9036.74,9063.87,7738.48416,8990.82332600003,7738.48416,8990.82332600003,43.658940557550444,1441422.820769998,2941247.260451267,2941247.260451267,1441422.820769998,22.512596097931553,21.428571428571427,57.142857142857146,-31.032031563774083,-85.25455405889807,-54.22252249512398,43.658940557550444,25.472113327669746,32.424078035599194
1593820800,9059.73,9195.84,9039.84,9138.51,5300.80245,9014.372860000029,5300.80245,9014.372860000029,45.93782912287709,1446723.623219998,2942651.973100517,2942651.973100517,1446723.623219998,22.55913104453933,14.285714285714286,50,-23.827062723724126,-84.00635089977914,-60.17928817605501,45.93782912287709,33.111904932496756,28.96242540865319
1593907200,9138.51,9145,8905.84,9074.39,4601.34085,8314.97489750003,4601.34085,8314.97489750003,44.280836912282695,1442122.282369998,2944536.2987521687,2944536.2987521687,1442122.282369998,23.059191454451394,7.142857142857143,42.857142857142854,-21.605419358792105,-87.18606237454514,-65.58064301575304,44.280836912282695,26.54888995793194,28.377636072699527
1593993600,9074.37,9375.9,9061.59,9343.31,9959.29638,8295.67423350003,9959.29638,8295.67423350003,52.08669111586807,1452081.578749998,2952430.2871939917,2952430.2871939917,1452081.578749998,22.285303384902623,0,35.714285714285715,-1.3206121960077155,-67.23140826076269,-65.91079606475498,52.08669111586807,58.08558360453855,39.2487928316558
1594080000,9343.31,9379.34,9201.57,9253.94,6326.85311,8165.119868000031,6326.85311,8165.119868000031,49.5998417475446,1445754.725639998,2949831.141766623,2949831.141766623,1445754.725639998,21.54952158434792,0,28.571428571428573,6.360252156203728,-57.960480869500316,-64.32073302570404,49.5998417475446,51.73803882739852,45.457504129956384
1594166400,9253.94,9475,9232.2,9435.28,10135.32991,8356.85628000003,10135.32991,8356.85628000003,54.36132514102025,1455890.055549998,2956650.36538317,2956650.36538317,1455890.055549998,20.384093578399415,0,21.428571428571427,23.000149203197637,-35.570546521707,-58.57069572490464,54.36132514102025,93.98172699586367,67.93511647593363
1594252800,9435.28,9446.62,9154.79,9236.95,8450.14491,8385.76461800003,8450.14491,8385.76461800003,48.91806458073587,1447439.910639998,2952958.2227745485,2952958.2227745485,1447439.910639998,19.639773793919126,92.85714285714286,14.285714285714286,20.101029064506804,-33.44440939427113,-53.54543845877794,48.91806458073587,63.93127168593473,69.88367916973236
1594339200,9236.95,9322.23,9118,9291.05,6892.48486,8385.35768500003,6892.48486,8385.35768500003,50.377684074852034,1454332.395499998,2957746.142409706,2957746.142409706,1454332.395499998,19.108821169893602,85.71428571428571,7.142857142857143,21.17088672196737,-27.081830056318722,-48.25271677828609,50.377684074852034,72.12836558129656,76.68045475436503
1594425600,9291.04,9303.04,9182.35,9235,3369.2317,8399.385129500031,3369.2317,8399.385129500031,48.821203074128896,1450963.1637999981,2957316.5088372226,2957316.5088372226,1450963.1637999981,18.615793733298467,78.57142857142857,0,17.594570661136565,-26.259503451865385,-43.85407411300195,48.821203074128896,57.83259540375289,64.63074422366144
1594512000,9235,9347.53,9159.33,9303.37,5419.22796,8081.55887650003,5419.22796,8081.55887650003,50.817348641733915,1456382.3917599982,2960192.558192402,2960192.558192402,1456382.3917599982,17.887428194683004,71.42857142857143,50,19.193691469151318,-19.8619597765628,-39.05565124571412,50.817348641733915,69.84503478810892,66.60199859105283
1594598400,9303.38,9339.61,9193.52,9236.92,8698.45054,8119.131510500029,8698.45054,8119.131510500029,48.82414852913062,1447683.941219998,2956662.3293436337,2956662.3293436337,1447683.941219998,17.211088765968647,64.28571428571429,42.857142857142854,15.30520354527026,-19.92414681412629,-35.22935035939655,48.82414852913062,58.169934640522875,61.94918827746161
1594684800,9236.91,9280,9100,9256.94,7497.57779,7823.471747500031,7497.57779,7823.471747500031,49.46722967932858,1455181.519009998,2962238.861090996,2962238.861090996,1455181.519009998,17.080463277127826,57.142857142857146,35.714285714285715,13.66445947878318,-18.148776010917572,-31.81323548970075,49.46722967932858,61.68739897392657,63.23412280085282
1594771200,9256.94,9273.98,9154.01,9190.16,7196.34305,7506.83536300003,7196.34305,7506.83536300003,47.33069188050832,1447985.175959998,2959379.398948848,2959379.398948848,1447985.175959998,16.959168180347064,50,28.571428571428573,7.948050944680354,-21.87817180885031,-29.826222753530665,47.33069188050832,49.95431864502069,56.603884086490076
1594857600,9190.8,9216.02,9005,9130.11,8765.71328,7410.00164750003,8765.71328,7410.00164750003,45.43052381051841,1439219.462679998,2961007.7562636808,2961007.7562636808,1439219.462679998,17.5911732376354,42.857142857142854,21.428571428571427,0.38813612396048214,-29.341052598580063,-29.729188722540545,45.43052381051841,39.40368262000149,50.34846674631629
1594944000,9130.93,9182.99,9054.99,9154.29,6423.76093,7305.82555600003,6423.76093,7305.82555600003,46.36427525040569,1445643.2236099981,2964550.861901634,2964550.861901634,1445643.2236099981,18.178035076546,35.714285714285715,14.285714285714286,-2.5564723128711506,-32.924779113629484,-30.368306800758333,46.36427525040569,43.65204863307344,44.336683299365255
1595030400,9154.29,9210,9122.65,9175.85,4121.64135,7235.01902750003,4121.64135,7235.01902750003,47.2313069593116,1449764.864959998,2965449.7430432197,2965449.7430432197,1449764.864959998,18.496115826477368,28.571428571428573,7.142857142857143,-2.61531044330858,-33.637444854894056,-31.022134411585476,47.2313069593116,47.44008714596955,43.49860613301487
1595116800,9175.83,9245.03,9105.37,9212.87,3520.08686,6978.1013140000305,3520.08686,6978.1013140000305,48.76288056791618,1453284.951819998,2967348.6643093834,2967348.6643093834,1453284.951819998,18.493138624073183,21.428571428571427,0,0.1302626438076615,-30.859306106825898,-30.98956875063356,48.76288056791618,44.227659574468255,45.10659845117046
1595203200,9214.01,9223.51,9131,9161.05,5815.34532,6927.82449250003,5815.34532,6927.82449250003,46.71879601614986,1447469.606499998,2965311.3133006147,2965311.3133006147,1447469.606499998,18.490374078983578,14.285714285714286,71.42857142857143,-1.180199274934882,-32.46481784430216,-31.28461856936728,46.71879601614986,33.202127659574316,41.62329146000408
1595289600,9161.05,9438,9157.04,9394.14,9603.92961,7030.512259000029,9603.92961,7030.512259000029,55.711863060756386,1457073.536109998,2971916.7495115926,2971916.7495115926,1457073.536109998,17.499321793276593,7.142857142857143,64.28571428571429,13.220771733491198,-14.758653902503283,-27.97942563599448,55.711863060756386,82.79574468085094,53.40851063829788
1595376000,9394.14,9567.77,9277,9536.18,10362.36698,7009.920600000029,10362.36698,7009.920600000029,60.128283755516975,1467435.9030899978,2980027.5281372354,2980027.5281372354,1467435.9030899978,17.346269834435805,100,57.142857142857146,30.873710719225226,10.612712763037052,-20.260997956188174,60.128283755516975,94.38669438669436,70.1281889090399
1595462400,9536.2,9686,9450.04,9613.24,12992.98635,7272.645709500028,12992.98635,7272.645709500028,62.32340109922529,1480428.8894399977,2985007.5488419905,2985007.5488419905,1480428.8894399977,17.805678444730475,100,50,45.422284773605256,36.516858010818396,-8.905426762786858,62.32340109922529,89.31571218795885,88.83271708516808
1595548800,9613.24,9645.55,9475.7,9551.21,9798.90752,7497.550963000029,9798.90752,7497.550963000029,59.484476144383734,1470629.9819199978,2983921.217204654,2983921.217204654,1470629.9819199978,18.23227215428981,92.85714285714286,42.857142857142854,48.28251730286555,51.44771986579508,3.1652025629295313,59.484476144383734,80.20704845814966,87.96981834426765
1595635200,9551.21,9747.76,9536.64,9711.33,6973.12538,7616.140189500029,6973.12538,7616.140189500029,64.03825566495614,1477603.107299998,2988487.8348393585,2988487.8348393585,1477603.107299998,19.122231429052345,100,35.714285714285715,57.73383408310371,75.33249516680917,17.59866108370546,64.03825566495614,95.09532015725131,88.2060269344533
1595721600,9711.79,10150,9661.35,9941,11615.06043,7698.928392000031,11615.06043,7698.928392000031,69.35821146948709,1489218.167729998,2990167.163641936,2990167.163641936,1489218.167729998,21.32328552133746,100,28.571428571428573,75.1277925704394,111.5084017967547,36.38060922631531,69.35821146948709,81.7467248908297,85.68303116874358
1595808000,9941,11420,9935,11048.91,41850.58745,9475.115109000031,41850.58745,9475.115109000031,82.67371552541337,1531068.755179998,3011101.475675343,3011101.475675343,1531068.755179998,25.103725599478093,100,21.428571428571427,152.4642185943532,226.96088246925683,74.49666387490362,82.67371552541337,84.63395445134576,87.15866649980894
1595894400,11048.05,11259,10575,10934.23,26011.38943,10268.91808500003,26011.38943,10268.91808500003,78.85396565464598,1505057.365749998,3012411.932517094,3012411.932517094,1505057.365749998,28.614134243465823,92.85714285714286,14.285714285714286,184.94698434570688,305.6803943070372,120.73340996133034,78.85396565464598,79.88530020703931,82.08865984973828
1595980800,10934.22,11350,10843.47,11110.12,18556.29228,10774.22545350003,18556.29228,10774.22545350003,80.35328954609616,1523613.658029998,3013392.6285160193,3013392.6285160193,1523613.658029998,31.945149592496875,85.71428571428571,7.142857142857143,205.73551152935437,377.9027993730233,172.16728784366893,80.35328954609616,87.16853002070397,83.89592822636304
1596067200,11108.16,11188.65,10811,11115.95,12408.71844,11050.03713250003,12408.71844,11050.03713250003,80.40288829086865,1536022.376469998,3021023.8342824434,3021023.8342824434,1536022.376469998,34.85438588738429,78.57142857142857,0,206.7828028318126,430.6457913834347,223.8629885516221,80.40288829086865,87.14381757371008,84.73254926715116
1596153600,11115.99,11460,10975,11351.62,15747.0361,11668.92735250003,15747.0361,11668.92735250003,82.34336812499326,1551769.4125699978,3029733.0816297918,3029733.0816297918,1551769.4125699978,37.783692898503304,100,0,209.59832121093052,485.8608900652853,276.26256885435475,82.34336812499326,95.39715369293693,89.9031670957837
1596240000,11351.61,11888,11237.82,11810.07,18293.13975,12312.62294200003,18293.13975,12312.62294200003,85.37678610545525,1570062.552319998,3043641.0222634934,3043641.0222634934,1570062.552319998,40.789066464999635,100,7.142857142857143,227.11411811346852,560.1552164961904,333.0410983827219,85.37678610545525,97.19941206700135,93.24679444454948
1596326400,11810.07,12134.29,10546.15,11068.54,28118.44344,13283.62258700003,28118.44344,13283.62258700003,65.71195521530994,1541944.1088799979,3034020.688144613,3034020.688144613,1541944.1088799979,40.70698877388666,100,0,175.82799854208895,552.8260965603331,376.99809801824415,65.71195521530994,64.51391640500918,85.70349405498251
1596412800,11067.46,11486.6,10911.74,11233.13,13783.35486,13597.911440500033,13783.35486,13597.911440500033,67.50122882436125,1555727.463739998,3035649.198498597,3035649.198498597,1555727.463739998,40.63077377499604,92.85714285714286,0,141.5323877371414,553.9135826896709,412.3811949525295,67.50122882436125,69.73179947938527,77.14837598379863
1596499200,11233.16,11417.11,11006.16,11197.04,12074.49298,13841.81893700003,12074.49298,13841.81893700003,66.67956360400342,1543652.9707599978,3034791.540754136,3034791.540754136,1543652.9707599978,40.5600027045976,85.71428571428571,0,106.55442153970677,545.5742218771629,439.01980033745616,66.67956360400342,67.19793930612575,67.14788506350676
1596585600,11197.05,11798.87,11073.7,11756.75,16637.78645,14235.42259550003,16637.78645,14235.42259550003,72.30919192187514,1560290.7572099979,3049496.5843568756,3049496.5843568756,1560290.7572099979,41.07012854127444,78.57142857142857,0,110.76207601023128,577.4723953502453,466.710319340014,72.30919192187514,85.93499115209087,74.288243312534
1596672000,11756.75,11916.68,11580.19,11773.89,18053.09584,14816.889341000031,18053.09584,14816.889341000031,72.4626267628573,1578343.853049998,3052227.9674862833,3052227.9674862833,1578343.853049998,41.70258216546666,71.42857142857143,0,104.43194713000008,597.2502532525141,492.818306122514,72.4626267628573,86.44394208960384,79.85895751594018
1596758400,11773.89,11920,11350,11606.52,23761.52509,15798.883528000031,23761.52509,15798.883528000031,68.47276624605765,1554582.327959998,3049853.4824527283,3049853.4824527283,1554582.327959998,41.41077592033852,64.28571428571429,0,79.81575692933075,592.5880022841775,512.7722453548467,68.47276624605765,79.6827902142321,84.02057448530896
1596844800,11606.52,11818.18,11529.45,11774.98,7315.89769,15988.674069500034,7315.89769,15988.674069500034,70.24841712327864,1561898.225649998,3054980.1599009247,3054980.1599009247,1561898.225649998,41.139812978433824,57.142857142857146,0,66.27860890431043,595.6205064852347,529.3418975809243,70.24841712327864,85.47033086124203,83.86568772169268
1596931200,11773.24,11810.24,11532.04,11688.48,7595.85556,16077.699581500032,7595.85556,16077.699581500032,68.12667356637444,1554302.370089998,3055927.04800596,3055927.04800596,1554302.370089998,40.88820453237946,50,0,43.97321562339005,584.3084171101618,540.3352014867718,68.12667356637444,79.7293672048706,81.62749609344827
1597017600,11688.25,12086.22,11470.01,11899.73,22152.6035,16705.133276000033,22152.6035,16705.133276000033,70.472262049696,1576454.973589998,3064671.1088769375,3064671.1088769375,1576454.973589998,41.1423411188319,42.857142857142854,0,36.24282720734959,585.6387354959588,549.3959082886092,70.472262049696,85.23052123868166,83.47673976826479
1597104000,11899.87,11943,11120,11388.53,20706.62441,17222.346147500033,20706.62441,17222.346147500033,59.131940430741224,1555748.349179998,3057476.8777909162,3057476.8777909162,1555748.349179998,40.036381247514456,35.714285714285715,35.714285714285715,-8.134666748968243,539.2275748523989,547.3622416013671,59.131940430741224,53.04192325613613,72.66727056656283
1597190400,11388.88,11625,11148.54,11566.45,12810.00362,17213.197011000033,12810.00362,17213.197011000033,61.456682931841875,1568558.3527999981,3067138.5553732594,3067138.5553732594,1568558.3527999981,39.009418509862535,28.571428571428573,28.571428571428573,-29.158945880972396,510.9135592501516,540.072505131124,61.456682931841875,64.24496580905968,67.50580343462586
1597276800,11566.44,11802.09,11274.14,11795.95,15369.41826,17491.72254800003,15369.41826,17491.72254800003,64.2793086657164,1583927.771059998,3082150.4843705776,3082150.4843705776,1583927.771059998,38.43233966145344,21.428571428571427,21.428571428571427,-31.085580699349748,501.21552925693686,532.3011099562866,64.2793086657164,78.69583286108279,65.32757397542623
1597363200,11795.95,11865.97,11651.24,11779,13797.83431,17832.957994500033,13797.83431,17832.957994500033,63.90706716335597,1570129.936749998,3084771.5138564664,3084771.5138564664,1570129.936749998,38.02873564792259,14.285714285714286,14.285714285714286,-36.59819758548997,486.5533629744241,523.1515605599141,63.90706716335597,77.62854660168495,73.52311509060918
1597449600,11777.5,11989.98,11688,11859.24,12567.05316,17880.557631000032,12567.05316,17880.557631000032,64.94207978126958,1582696.989909998,3086456.94220596,3086456.94220596,1582696.989909998,37.90876386555128,7.142857142857143,7.142857142857143,-37.78360463155673,475.9220547704681,513.7056594020248,64.94207978126958,82.68099789691078,79.66845911989287
1597536000,11860.02,11940,11686.53,11918.84,8911.26831,16233.591674000034,8911.26831,16233.591674000034,65.72822024800004,1591608.2582199979,3093880.3623490008,3093880.3623490008,1591608.2582199979,37.79076789928638,0,0,-37.42573948910848,466.9234850406392,504.3492245297477,65.72822024800004,85.74858660854171,82.01937703571252
1597622400,11918.84,12486.61,11775,12304.26,23814.67481,16123.755943000035,23814.67481,16123.755943000035,70.35739007413832,1615422.9330299979,3105490.020502114,3105490.020502114,1615422.9330299979,38.65230496085484,100,0,-15.240969063344664,485.29801320056686,500.5389822639115,70.35739007413832,87.6827991489074,85.37079455145334
1597708800,12303.98,12400,11825,11950,18628.92719,16127.387688500035,18628.92719,16127.387688500035,62.05984371312246,1596794.005839998,3094960.6268729838,3094960.6268729838,1596794.005839998,39.4523036608827,92.85714285714286,0,-27.70839190895913,465.9034923777126,493.61188428667174,62.05984371312246,62.02093551606255,78.4841070911706
1597795200,11954.22,12024.83,11569,11758.87,16646.3293,16339.268231500033,16646.3293,16339.268231500033,58.08006876775087,1580147.6765399978,3092181.9172741487,3092181.9172741487,1580147.6765399978,39.083883244010394,85.71428571428571,0,-50.767846736958745,430.1520758654733,480.91992260243205,58.08006876775087,46.74852371927621,65.4840861280821
1597881600,11758.87,11892.16,11671.48,11864.26,8801.19192,15991.976022500032,8801.19192,15991.976022500032,59.61784299210826,1588948.8684599977,3098757.685462338,3098757.685462338,1588948.8684599977,38.74177857120039,78.57142857142857,35.714285714285715,-60.21844341652468,405.6468683317762,465.8653117483009,59.61784299210826,54.460306890773516,54.40992204203747
1597968000,11864.26,11884.99,11480,11529.22,14865.39303,15820.588686500032,14865.39303,15820.588686500032,52.96587561380426,1574083.4754299978,3087505.5897727,3087505.5897727,1574083.4754299978,37.63157495311524,71.42857142857143,28.571428571428573,-88.61381922346192,355.0980377189735,443.7118569424354,52.96587561380426,29.94416841673917,43.717666342263016
1598054400,11529.99,11693.16,11370,11672.93,7946.03898,14811.968463500034,7946.03898,14811.968463500034,55.27122053099034,1582029.5144099977,3094456.7756238137,3094456.7756238137,1582029.5144099977,36.17274289059154,64.28571428571429,21.428571428571427,-96.64020767369135,322.91159735032124,419.5518050240126,55.27122053099034,40.459970291451114,41.62148186632131
1598140800,11672.92,11715,11525.62,11650.01,5516.18486,14398.609963500032,5516.18486,14398.609963500032,54.809803731007065,1576513.3295499978,3096186.9550550315,3096186.9550550315,1576513.3295499978,34.87896941696508,57.142857142857146,14.285714285714286,-101.89262765640092,292.18602045351145,394.07864810991236,54.809803731007065,38.782827580655784,36.3956554296154
1598227200,11650.01,11823.62,11592.91,11753.85,7253.03357,14157.536993000034,7253.03357,14157.536993000034,56.5784243202359,1583766.3631199978,3099053.146683383,3099053.146683383,1583766.3631199978,33.983349810426944,50,7.142857142857143,-96.80927643494886,273.06705256622627,369.8763290011751,56.5784243202359,46.38119141525381,41.87466309578695
1598313600,11753.26,11769.76,11102.73,11324.92,14348.64982,14043.080161500033,14348.64982,14043.080161500033,48.18879221707062,1569417.7132999978,3094263.6666263794,3094263.6666263794,1569417.7132999978,31.729544241727435,42.857142857142854,100,-119.29363055939712,220.75929080192873,340.05292136132584,48.18879221707062,16.055582854004708,33.73986728330481
1598400000,11324.92,11539.99,11254.89,11463.27,9124.56855,13596.653797000032,9124.56855,13596.653797000032,50.72672948056644,1578542.2818499978,3098477.4186267057,3098477.4186267057,1578542.2818499978,29.636724785077895,35.714285714285715,92.85714285714286,-121.4038426774652,188.29811801449432,309.7019606919595,50.72672948056644,26.052836951180783,29.496537073479814
1598486400,11463.27,11597.92,11125,11330.06,13517.40228,13084.447656500033,13517.40228,13084.447656500033,48.27473540624459,1565024.8795699978,3096682.41553277,3096682.41553277,1565024.8795699978,28.10164090931961,28.571428571428573,85.71428571428571,-127.68693736385842,150.09328898713648,277.7802263509949,48.27473540624459,16.427002341243444,19.511807382143026
1598572800,11330.56,11550.51,11282.09,11535,10373.91036,13237.348290000033,10373.91036,13237.348290000033,52.1100543419798,1575398.7899299979,3105857.4632917447,3105857.4632917447,1575398.7899299979,26.676205881829766,21.428571428571427,78.57142857142857,-114.38517641751687,134.7987558290988,249.18393224661568,52.1100543419798,31.236089834378713,24.571976375601025
1598659200,11535,11580,11422.21,11474.31,5417.55568,13128.433296000032,5417.55568,13128.433296000032,50.90627964150462,1569981.234249998,3104017.5063306494,3104017.5063306494,1569981.234249998,25.23524979364586,14.285714285714286,71.42857142857143,-106.1964867562979,116.43832380124331,222.63481055754121,50.90627964150462,26.850593982137156,24.83789538591982
1598745600,11474.3,11720,11463.87,11716.01,5594.24031,12300.515136500031,5594.24031,12300.515136500031,55.33181845851723,1575575.474559998,3109437.452189887,3109437.452189887,1575575.474559998,23.516454691561293,7.142857142857143,64.28571428571429,-82.10196912666837,120.00734914920577,202.10931827587413,55.33181845851723,44.31598115443537,34.13422165698379
1598832000,11716,11784.66,11576,11655,9123.60782,11721.364307000033,9123.60782,11721.364307000033,54.00836016750943,1566451.8667399979,3107222.355994348,3107222.355994348,1566451.8667399979,22.164697007231172,0,57.142857142857146,-68.43217912106633,116.56909437454124,185.00127349560756,54.00836016750943,42.57170827969507,37.91276113875591
1598918400,11655,12086,11525.09,11924.22,16057.65857,11883.747054500032,16057.65857,11883.747054500032,58.70244209005032,1582509.5253099978,3114017.18094236,3114017.18094236,1582509.5253099978,21.917887793866818,0,50,-40.78252150888906,134.02312160949623,174.8056431183853,58.70244209005032,83.54673690847878,56.81147544753645
1599004800,11924.22,11950,11160,11395.48,19721.45746,12101.349014500032,19721.45746,12101.349014500032,48.28021571193212,1562788.067849998,3106052.7077929443,3106052.7077929443,1562788.067849998,20.388067245725153,92.85714285714286,42.857142857142854,-56.65098586084375,103.9919107923306,160.64289665317435,48.28021571193212,29.773104030429064,51.963849739534346
1599091200,11395.49,11474.99,10005,10172.52,30364.25846,12929.670222000033,30364.25846,12929.670222000033,33.475828471656655,1532423.809389998,3082609.0686258906,3082609.0686258906,1532423.809389998,21.493300798518376,85.71428571428571,100,-143.13829437047642,-18.279971309921166,124.85832306055525,33.475828471656655,8.049975973089882,40.45660563733262
1599177600,10172.13,10638.34,9895.22,10500.05,23366.47624,13469.641376000032,23366.47624,13469.641376000032,38.881131615174645,1555790.285629998,3097278.833704222,3097278.833704222,1555790.285629998,22.680395154576825,78.57142857142857,100,-170.07942795878392,-87.74096188792464,82.33846607085927,38.881131615174645,27.607975241694728,21.81035174840461
1599264000,10500.05,10564.8,9813,10168.36,22450.77217,14146.61656900003,22450.77217,14146.61656900003,35.716149974764335,1533339.513459998,3096052.074299136,3096052.074299136,1533339.513459998,23.90439947020631,71.42857142857143,100,-199.96810888873546,-167.62167004006005,32.3464388486754,35.716149974764335,15.633963924329105,17.09730504637129
1599350400,10169.58,10358.88,10000,10257.86,9516.20737,13431.693197000033,9516.20737,13431.693197000033,37.20159389327944,1542855.720829998,3100210.907234688,3100210.907234688,1542855.720829998,25.040974906147976,64.28571428571429,92.85714285714286,-202.8023117529868,-221.15645084255812,-18.354139089571312,37.20159389327944,19.571491421029503,20.937810195684495
1599436800,10258.67,10410.9,9880,10375,11996.94301,13100.093988000033,11996.94301,13100.093988000033,39.18243781204959,1554852.663839998,3110585.3591764676,3110585.3591764676,1554852.663839998,26.287777309623273,57.142857142857146,85.71428571428571,-186.30457058145862,-251.2348523163946,-64.93028173493597,39.18243781204959,24.725032996040476,19.976829447133078
1599523200,10375,10440.91,9819.83,10125.69,15768.29879,13056.192462500032,15768.29879,13056.192462500032,36.54065491164868,1539084.365049998,3110347.722677668,3110347.722677668,1539084.365049998,27.54196089368326,50,78.57142857142857,-181.51613736782184,-291.8254534447133,-110.30931607689143,36.54065491164868,13.756709194896635,19.351077870655587
1599609600,10126.41,10349.99,9983.34,10224.56,9645.51474,13098.408603500033,9645.51474,13098.408603500033,38.31681449925077,1548729.879789998,3113393.82700535,3113393.82700535,1548729.879789998,28.70655993602468,42.857142857142854,71.42857142857143,-161.6841429347331,-312.4144947453078,-150.73035181057472,38.31681449925077,18.106467223933105,18.862736471623453
1599696000,10224.56,10489,10216.41,10343.23,11237.03336,12916.990620000031,11237.03336,12916.990620000031,40.47048775215632,1559966.913149998,3112612.6472769226,3112612.6472769226,1559966.913149998,29.179849777799266,35.714285714285715,64.28571428571429,-131.83066107982583,-315.518678160357,-183.68801708053118,40.47048775215632,23.3273207215134,18.39683238011443
1599782400,10344.24,10411.44,10200,10394.41,7200.30582,12879.703962000032,7200.30582,12879.703962000032,41.42044295684272,1567167.218969998,3118653.0854454413,3118653.0854454413,1567167.218969998,29.653829297952804,28.571428571428573,57.142857142857146,-101.26745929462302,-310.27234119880995,-209.00488190418693,41.42044295684272,25.57897052353717,22.337586156327944
1599868800,10394.41,10483.23,10276.19,10446.52,6495.31475,12928.66045650003,6495.31475,12928.66045650003,42.42781293816138,1573662.5337199979,3122845.0481429636,3122845.0481429636,1573662.5337199979,29.7642246667647,21.428571428571427,50,-71.57143289616417,-298.46917302439215,-226.89774012822798,42.42781293816138,27.87153541575013,25.59260888693362
1599955200,10446.52,10582.36,10211,10336.76,10442.20816,13088.11918600003,10442.20816,13088.11918600003,40.83493499379925,1563220.325559998,3119475.2877328643,3119475.2877328643,1563220.325559998,29.415865361209093,14.285714285714286,42.857142857142854,-54.14268947348336,-294.57610197008216,-240.4334124965988,40.83493499379925,23.042674879014527,25.497726939433992
1600041600,10336.76,10760.62,10253,10679.95,13532.96146,13047.334768000032,13532.96146,13047.334768000032,47.4750107659773,1576753.2870199978,3128706.984463428,3128706.984463428,1576753.2870199978,28.332093681185594,7.142857142857143,35.714285714285715,-16.286871925646977,-260.79200240365753,-244.50513047801056,47.4750107659773,38.141223053233645,29.68514444933282
1600128000,10678.41,10950,10613.18,10783.75,12634.34358,13222.82351950003,12634.34358,13222.82351950003,49.32738371179607,1589387.630599998,3128869.0305541162,3128869.0305541162,1589387.630599998,26.600714491186277,0,28.571428571428573,17.147585970323888,-223.0706480151057,-240.21823398542958,49.32738371179607,45.42583060364998,35.53657617863277
1600214400,10783.36,11099.95,10662.02,10959.61,11003.71552,13097.13918150003,11003.71552,13097.13918150003,52.390811417324095,1600391.346119998,3132820.196871838,3132820.196871838,1600391.346119998,24.93194854966412,0,21.428571428571427,50.61774979942109,-176.94604673615322,-227.5637965355743,52.390811417324095,68.99018646321582,50.85241337336654
1600300800,10957.06,11044,10735.55,10943.61,8885.46358,13022.71684250003,8885.46358,13022.71684250003,52.082306483584276,1591505.882539998,3135921.827164134,3135921.827164134,1591505.882539998,23.382380175393543,0,14.285714285714286,69.99630705014991,-140.06841272288693,-210.06471977303684,52.082306483584276,87.85189789813124,67.42263832166573
1600387200,10943.99,11039.88,10813,10937.52,8660.07378,13184.84274750003,8660.07378,13184.84274750003,51.956896478900624,1582845.808759998,3136767.680632773,3136767.680632773,1582845.808759998,21.943495256428008,85.71428571428571,7.142857142857143,79.99955961058077,-110.06527025981086,-190.06482987039163,51.956896478900624,87.3786860406387,81.40692346732864
1600473600,10937.5,11179.9,10891.78,11080,5718.03639,13191.03255150003,5718.03639,13191.03255150003,54.70488335804179,1588563.845149998,3138520.4814586956,3138520.4814586956,1588563.845149998,21.13198082537772,100,0,92.90122092695006,-73.93830371170407,-166.83952463865413,54.70488335804179,92.65478982699422,89.29512458858811
1600560000,11081.09,11081.37,10759.37,10920.89,6003.79938,13035.04212950003,6003.79938,13035.04212950003,51.184042189998586,1582560.045769998,3138539.8726119725,3138539.8726119725,1582560.045769998,19.81169249835032,92.85714285714286,14.285714285714286,87.48471238959658,-57.48363415165841,-144.968346541255,51.184042189998586,80.9561272581558,86.99653437526297
1600646400,10920.94,10994,10180,10416.82,15004.72579,12982.39549050003,15004.72579,12982.39549050003,41.968483445504496,1567555.319979998,3132265.9064327534,3132265.9064327534,1567555.319979998,20.06002201124598,85.71428571428571,7.142857142857143,48.65673553132257,-84.14742712710176,-132.80416265842433,41.968483445504496,43.89406427610343,72.5016604537512
1600732800,10416.83,10576.82,10355,10531.13,7904.27071,12391.53615300003,7904.27071,12391.53615300003,44.41270564442575,1575459.5906899981,3136913.968245991,3136913.968245991,1575459.5906899981,20.290613701791944,78.57142857142857,0,30.275192733345335,-94.96017174174267,-125.235364475088,44.41270564442575,45.78040382429626,56.876865119518556
1600819200,10531.13,10541.25,10135.22,10235.1,8893.25676,11317.98606800003,8893.25676,11317.98606800003,39.74411516301553,1566566.333929998,3132396.0457479362,3132396.0457479362,1566566.333929998,21.052903474945612,71.42857142857143,0,-0.583273920580794,-125.964456875814,-125.3811829552332,39.74411516301553,9.56082245280861,33.07843018440282
1600905600,10237.41,10795.87,10192.56,10740.01,9678.40803,10633.582657500028,9678.40803,10633.582657500028,49.495598972982584,1576244.7419599982,3140282.221351635,3140282.221351635,1576244.7419599982,20.722718682544066,64.28571428571429,92.85714285714286,13.47106614133294,-108.54235027856703,-122.01341641989997,49.495598972982584,57.892368955086795,37.74453174406394
1600992000,10740,10765.07,10551,10690.53,9690.64221,9995.576159500028,9690.64221,9995.576159500028,48.66444137314687,1566554.0997499982,3143224.225542918,3143224.225542918,1566554.0997499982,20.416118518171203,57.142857142857146,85.71428571428571,19.528553688807833,-97.60272430889017,-117.131277997698,48.66444137314687,53.155990351112415,40.20306058633599
1601078400,10690.53,10828,10654.58,10730,3783.41168,9708.936375000028,3783.41168,9708.936375000028,49.3944650320313,1570337.511429998,3142731.6097215917,3142731.6097215917,1570337.511429998,19.875051084711387,50,78.57142857142857,25.888297170754313,-84.77090653425512,-110.65920370500943,49.3944650320313,56.93418080177667,55.99418003599201
1601164800,10730,10806.32,10595.24,10778.2,3880.05123,9303.09178600003,3880.05123,9303.09178600003,50.32350455043818,1574217.5626599982,3145577.8629547413,3145577.8629547413,1574217.5626599982,19.56160256134694,42.857142857142854,71.42857142857143,32.60222409366753,-69.90642358792502,-102.50864768159255,50.32350455043818,61.54803384768553,57.21273500019159
1601251200,10779,10956.11,10621.22,10695.55,8876.07602,8958.48064750003,8876.07602,8958.48064750003,48.67341141814507,1565341.4866399982,3140641.9388088887,3140641.9388088887,1565341.4866399982,18.641757514250347,35.714285714285715,64.28571428571429,30.761342818163627,-64.05696915888802,-94.81831197705165,48.67341141814507,53.63652027415091,57.37291164120442
1601337600,10694.9,10860.79,10636.13,10840.73,8200.79695,8886.244758000028,8200.79695,8886.244758000028,51.67114285049139,1573542.2835899983,3147378.2295110743,3147378.2295110743,1573542.2835899983,17.787615684803512,28.571428571428573,57.142857142857146,38.1244425613598,-47.162758775351904,-85.2872013367117,51.67114285049139,67.53359880537582,60.90605097573748
1601424000,10839.98,10847,10657.04,10779.63,6318.54372,8640.320276000028,6318.54372,8640.320276000028,50.338631766118056,1567223.7398699983,3149214.984534334,3149214.984534334,1567223.7398699983,16.99448398603145,21.428571428571427,50,37.61923243216248,-38.2631607965086,-75.88239322867108,50.338631766118056,61.684917869586826,60.95167898303791
1601510400,10779.63,10931.98,10427.75,10617.63,12848.7325,8922.741610000028,12848.7325,8922.741610000028,46.886191243808895,1554375.0073699984,3146043.253906892,3146043.253906892,1554375.0073699984,17.105819189197085,14.285714285714286,42.857142857142854,25.683857939731865,-43.777570804006245,-69.46142874373811,46.886191243808895,46.17777692690582,58.465431200622874
1601596800,10616.35,10668.56,10363.76,10573.12,10263.49718,9111.150731500029,10263.49718,9111.150731500029,45.953641528921416,1544111.5101899984,3149879.269650808,3149879.269650808,1544111.5101899984,17.4234104058996,7.142857142857143,35.714285714285715,14.649348531052325,-51.1497430799227,-65.79909161097503,45.953641528921416,41.917142091358244,49.92661229595035
1601683200,10573.12,10606.36,10498.02,10551.65,3211.71899,8749.626273000027,3211.71899,8749.626273000027,45.4837019991788,1540899.7911999985,3149847.2532532704,3149847.2532532704,1540899.7911999985,17.718316535694786,0,28.571428571428573,6.1949012668769114,-58.05546502737889,-64.2503662942558,45.4837019991788,44.01310574433226,44.036008254198826
1601769600,10550.32,10697,10521.87,10671.11,3569.27039,8251.441719500028,3569.27039,8251.441719500028,48.631412747618164,1544469.0615899984,3152361.211470632,3152361.211470632,1544469.0615899984,17.496939810943427,0,21.428571428571427,8.780486995401908,-53.274757550003415,-62.05524454540532,48.631412747618164,62.401313491231846,49.44385377564084
1601856000,10670.01,10800,10621.12,10795,6081.40099,7923.794590000029,6081.40099,7923.794590000029,51.74330439023821,1550550.4625799984,3158102.641475055,3158102.641475055,1550550.4625799984,16.757193144421926,0,14.285714285714286,18.412910591144723,-39.03910630647442,-57.452016897619146,51.74330439023821,80.37374069607372,62.26271997721267
1601942400,10796.97,10800,10524,10602.66,7596.37803,7753.427715500028,7596.37803,7753.427715500028,46.98448365726729,1542954.0845499984,3154836.198922155,3154836.198922155,1542954.0845499984,16.482434748966575,42.857142857142854,7.142857142857143,11.734181503562638,-42.78429001816585,-54.518471521728486,46.98448365726729,56.943073980679486,66.57270938932841
1602028800,10601.2,10683.75,10546.78,10670.47,6108.05699,7614.557386000028,6108.05699,7614.557386000028,48.77323881760479,1549062.1415399984,3159759.8360125097,3159759.8360125097,1549062.1415399984,16.227301953186608,35.714285714285715,0,11.757468597396795,-39.8216357749825,-51.57910437237929,48.77323881760479,62.59053107196636,66.6357819162399
1602115200,10670.47,10963.16,10532.11,10933.09,11301.26536,7746.616965000027,11301.26536,7746.616965000027,55.09274507947777,1560363.4068999984,3169484.35134641,3169484.35134641,1560363.4068999984,15.530993599212334,100,0,28.38575028526899,-16.096916515793055,-44.482666801062045,55.09274507947777,94.98331664998337,71.50564056754313
1602201600,10932.44,11111.11,10834.49,11057.07,10098.41344,7965.635817500028,10098.41344,7965.635817500028,57.74303319304988,1570461.8203399985,3175637.1479669637,3175637.1479669637,1570461.8203399985,15.480220571080347,100,50,45.63766111104281,12.564409587741466,-33.073251523301344,57.74303319304988,92.76911754867186,83.44765509020725
1602288000,11057.07,11498.98,11055.75,11299.5,9312.77373,8131.084535000028,9312.77373,8131.084535000028,62.4141465743886,1579774.5940699985,3176567.3117488087,3176567.3117488087,1579774.5940699985,16.656970173973097,100,42.857142857142854,69.83126174381042,54.215825656461675,-15.61543608734874,62.4141465743886,82.42807561529926,90.06016993798488
1602374400,11299.52,11444.25,11276.28,11374.01,5163.47909,7639.0222000000285,5163.47909,7639.0222000000285,63.7407873550658,1584938.0731599985,3177412.3676527445,3177412.3676527445,1584938.0731599985,17.749666233802078,92.85714285714286,35.714285714285715,86.23208886233544,92.17467499057057,5.942586128235121,63.7407873550658,88.99156110709824,88.0629180903565
1602460800,11374.01,11736.02,11187.6,11535.46,11056.93022,7796.655175500028,11056.93022,7796.655175500028,66.49998081860446,1595995.0033799985,3180382.145963904,3180382.145963904,1595995.0033799985,19.489933135536244,100,28.571428571428573,102.24056537344086,133.7432928450362,31.502727471595335,66.49998081860446,85.38469386267899,85.60144352835887
1602547200,11535.46,11561.45,11312.59,11428.22,8639.22711,7783.9536930000295,8639.22711,7783.9536930000295,63.06701485505099,1587355.7762699984,3179771.1582714827,3179771.1582714827,1587355.7762699984,21.105895258575114,92.85714285714286,21.428571428571427,99.7837383126509,156.23240036240895,56.448662049758056,63.06701485505099,77.5698482794805,83.9820344164193
1602633600,11428.22,11556.37,11290.83,11427.7,7078.71569,7653.96907600003,7078.71569,7653.96907600003,63.050018162631744,1580277.0605799984,3179989.752338885,3179989.752338885,1580277.0605799984,22.477023237754658,85.71428571428571,14.285714285714286,92.46520139844739,172.0301637978173,79.5649623993699,63.050018162631744,77.53195458586568,80.16216557600843
1602720000,11427.7,11641.38,11263.15,11509.34,8538.52875,7596.36340300003,8538.52875,7596.36340300003,64.66032638396072,1588815.5893299985,3182566.6845145784,3182566.6845145784,1588815.5893299985,23.96728088536028,78.57142857142857,7.142857142857143,87.51560109493043,188.95946376803295,101.44386267310252,64.66032638396072,83.48126448340692,79.5276891162511
1602806400,11509.31,11550.01,11201,11328.95,9505.28051,7882.456844500031,9505.28051,7882.456844500031,58.58492716314483,1579310.3088199985,3180030.8354893755,3180030.8354893755,1579310.3088199985,24.95655131241582,71.42857142857143,0,67.3886623841769,185.67969065332363,118.29102826914674,58.58492716314483,67.1187399030695,76.04398632411409
1602892800,11328.27,11421,11264.75,11367.89,3586.15988,7867.762277000031,3586.15988,7867.762277000031,59.470204832590944,1582896.4686999985,3181179.0951936725,3181179.0951936725,1582896.4686999985,25.875159566110245,64.28571428571429,0,52.64748519131072,184.10038475828514,131.45289956697442,59.470204832590944,69.68002306140089,73.42667581595917
1602979200,11367.9,11523,11350.37,11514.2,4352.10945,7641.56394850003,4352.10945,7641.56394850003,62.69670041403212,1587248.5781499986,3185087.4977194993,3185087.4977194993,1587248.5781499986,27.031669042801642,57.142857142857146,0,48.78686414126781,192.43647974355918,143.64961560229136,62.69670041403212,81.69832180987116,72.83236159144724
1603065600,11514.2,11833,11416.04,11760.45,10313.24891,7747.18654650003,10313.24891,7747.18654650003,67.40055402325416,1597561.8270599986,3191811.7874563388,3191811.7874563388,1597561.8270599986,28.861929635927513,100,7.142857142857143,58.21508721495479,216.41847462098485,158.20338740603006,67.40055402325416,94.45760122230716,81.94531536452648
1603152000,11760.45,12050,11685,11923.83,13834.74195,8122.9964580000305,13834.74195,8122.9964580000305,70.09493290758812,1611396.5690099986,3196081.9847935634,3196081.9847935634,1611396.5690099986,30.970991070968047,100,0,70.05700354474592,245.77464183696247,175.71763829221655,70.09493290758812,91.68780346401913,89.2812421653992
1603238400,11923.07,13250.04,11900.01,12808,32404.64761,9100.79221350003,32404.64761,9100.79221350003,79.81695648993568,1643801.2166199987,3207266.1403707573,3207266.1403707573,1643801.2166199987,34.17481814855628,100,7.142857142857143,128.63046304558856,336.50571709920223,207.87525405361367,79.81695648993568,83.7361521451987,89.96051894384173
1603324800,12808.01,13200,12698.02,12987.02,20337.75909,9604.50530900003,20337.75909,9604.50530900003,81.15295397677241,1664138.9757099987,3210346.096635991,3210346.096635991,1664138.9757099987,37.149800434888206,92.85714285714286,0,168.1296304449466,418.0372921097969,249.9076616648503,81.15295397677241,89.1113825008797,88.17844603669924
1603411200,12988.2,13037,12722.72,12937.09,10450.8866,9966.46368950003,10450.8866,9966.46368950003,79.5709119480678,1653688.0891099987,3214152.2837310527,3214152.2837310527,1653688.0891099987,39.912283986482144,85.71428571428571,0,178.60853389322187,473.16832903137765,294.5597951381558,79.5709119480678,85.73798358466745,86.19517274358202
1603497600,12938,13175,12884.31,13126.24,7915.36098,10183.76821900003,7915.36098,10183.76821900003,81.07598131055008,1661603.4500899988,3219412.217958259,3219412.217958259,1661603.4500899988,42.57547166256339,78.57142857142857,0,185.1992187665639,526.0588185963607,340.85959982979676,81.07598131055008,93.99740113651787,89.61558907402173
1603584000,13126.34,13361,12890.76,13045,9276.1916,10343.50774950003,9276.1916,10343.50774950003,78.40423445985738,1652327.2584899988,3216221.258547711,3216221.258547711,1652327.2584899988,45.17242143101666,100,7.142857142857143,171.32958437162029,555.0215802943221,383.69199592270184,78.40423445985738,85.46056869421183,88.39865113846577
1603670400,13045.02,13250,12785,13068.79,12275.37275,10577.45748550003,12275.37275,10577.45748550003,78.62635610037597,1664602.6312399989,3218929.232175012,3218929.232175012,1664602.6312399989,47.014643344729166,92.85714285714286,0,151.675161846612,573.2859482309668,421.6107863843548,78.62635610037597,86.4717592592593,88.64324302999638
1603756800,13068.79,13793.72,13061.28,13698.18,17267.45357,11135.42731450003,17267.45357,11135.42731450003,83.47028460432682,1681870.0848099987,3231691.927637651,3231691.927637651,1681870.0848099987,49.13553848197741,100,21.428571428571427,167.7275423312011,631.2702142983562,463.5426719671551,83.47028460432682,96.31506680243146,89.41579825196759
1603843200,13740.85,13863.87,12891.57,13281.05,21073.39106,11624.033599500031,21073.39106,11624.033599500031,71.84849288335256,1660796.6937499987,3227501.524030184,3227501.524030184,1660796.6937499987,50.3180225342682,100,14.285714285714286,138.1500163409458,636.2301923933373,498.08017605239155,71.84849288335256,78.11308850976573,86.96663819048554
1603929600,13281.06,13650,12976.29,13460,15796.09108,11908.917481500031,15796.09108,11908.917481500031,73.54991924230536,1676592.7848299986,3234387.9735575872,3234387.9735575872,1676592.7848299986,51.416043439966785,92.85714285714286,7.142857142857143,119.24861297371854,647.1409422695397,527.8923292958211,73.54991924230536,84.83328138437098,86.42047889885612
1604016000,13460,13687.82,13131.31,13571.51,15664.30474,12226.494032000031,15664.30474,12226.494032000031,74.58087242529061,1692257.0895699987,3243504.632130189,3243504.632130189,1692257.0895699987,52.47449703920777,85.71428571428571,0,103.45398427499129,657.2098096395603,553.755825364569,74.58087242529061,88.75157745698543,83.89931578370744
1604102400,13571.51,14098.92,13424.73,13804.81,12166.31884,12576.63601950003,12166.31884,12576.63601950003,76.63298327791323,1704423.4084099988,3245056.0322261183,3245056.0322261183,1704423.4084099988,53.83496398666993,100,0,97.971163005628,676.219779121604,578.248616115976,76.63298327791323,89.2994488002765,87.62810254721103
1604188800,13803.69,13906.74,13630.05,13771.59,6252.02047,12336.39053200003,6252.02047,12336.39053200003,75.69589164944719,1698171.3879399986,3245200.4191241027,3245200.4191241027,1698171.3879399986,55.09825472359909,92.85714285714286,0,82.00702155225292,680.7573930562921,598.7503715040392,75.69589164944719,87.79930522423665,88.61677716049958
1604275200,13771.7,13840,13215,13563.22,12191.84519,12514.021436000028,12191.84519,12514.021436000028,69.92038137440981,1685979.5427499986,3246593.9957967005,3246593.9957967005,1685979.5427499986,54.37324165112234,85.71428571428571,0,48.945683930836935,659.9324764175853,610.9867924867484,69.92038137440981,77.80788095711537,84.96887832720957
1604361600,13563.22,14081.45,13290,14035.8,13965.8026,12858.375781500028,13965.8026,12858.375781500028,74.64536441759435,1699945.3453499987,3258948.7329126145,3258948.7329126145,1699945.3453499987,54.047910664887524,78.57142857142857,0,50.246365990676054,673.7947499750935,623.5483839844175,74.64536441759435,97.12948688213703,87.57889102116309
1604448000,14034.35,14273.6,13530.01,14161.48,16894.79231,13276.188959500028,16894.79231,13276.188959500028,75.73692846928164,1716840.1376599986,3270748.6635009744,3270748.6635009744,1716840.1376599986,53.99844233596711,100,0,50.76344317069368,687.0026879477846,636.2392447770909,75.73692846928164,92.88389037687703,89.27375273870989
1604534400,14165.86,15775,14115,15608.21,31865.98894,14394.224381000027,31865.98894,14394.224381000027,84.18004893988194,1748706.1265999987,3296211.124374345,3296211.124374345,1748706.1265999987,55.192851929286014,100,0,134.95289058373157,804.9303580067553,669.9774674230238,84.18004893988194,94.5355603024624,94.84964585382556
1604620800,15608.06,15977.67,15190.36,15599.95,25150.40685,15472.43672950003,25150.40685,15472.43672950003,84.00032108246461,1723555.7197499988,3297229.2029791,3297229.2029791,1723555.7197499988,56.40932008447822,100,0,174.01156109192027,887.4919187879241,713.4803576960038,84.00032108246461,88.16914995912514,91.86286687948825
1604707200,15599.95,15779.24,14310,14834.09,23552.08341,16432.43542750003,23552.08341,16432.43542750003,69.2393976458636,1700003.6363399988,3290479.56354605,3290479.56354605,1700003.6363399988,55.15659737181133,92.85714285714286,14.285714285714286,133.99074526024788,880.9687892713137,746.9780440110658,69.2393976458636,64.18107728014483,82.29526251391086
1604793600,14834.09,15666,14721.9,15482.9,11856.3429,16509.59012700003,11856.3429,16509.59012700003,73.48953324760016,1711859.9792399989,3297737.0368665773,3297737.0368665773,1711859.9792399989,53.99335485290637,85.71428571428571,7.142857142857143,136.4779391730906,917.5754679774291,781.0975288043385,73.48953324760016,84.5029395458973,78.95105559505582
1604880000,15482.89,15856.9,14817.14,15342.25,21951.29082,16915.41757050003,21951.29082,16915.41757050003,71.19310556281467,1689908.6884199989,3297957.867156238,3297957.867156238,1689908.6884199989,53.115975452711616,78.57142857142857,0,114.78539355447776,924.5792707474357,809.7938771929579,71.19310556281467,79.41025890282233,76.0314252429549
1604966400,15342.1,15481.06,15090.08,15315.03,13489.68955,15969.669667500031,13489.68955,15969.669667500031,70.73244711900405,1676418.9988699988,3299990.7397028795,3299990.7397028795,1676418.9988699988,52.30126600967363,71.42857142857143,7.142857142857143,86.0518331997348,917.3586686926265,831.3068354928917,70.73244711900405,78.52823952561488,80.81381265811159
1605052800,15315.46,16000,15293.04,15705.79,15257.36927,15715.650176500032,15257.36927,15715.650176500032,73.39395681812532,1691676.3681399988,3302549.029497586,3302549.029497586,1691676.3681399988,52.0764920240271,100,0,80.88973951741013,932.4190098896543,851.5292703722441,73.39395681812532,90.26990022191285,82.7361328834501
1605139200,15705.79,16370.89,15446.82,16310.81,22153.75296,16300.79349450003,22153.75296,16300.79349450003,76.89706193298457,1713830.1210999987,3321822.053772883,3321822.053772883,1713830.1210999987,52.19282504539987,100,0,104.26159854184675,981.8562685495526,877.5946700077059,76.89706193298457,98.14543860623908,88.98119278458903
1605225600,16310.81,16491.92,15975,16339.56,14593.52964,16634.70192750003,14593.52964,16634.70192750003,77.05168577722621,1728423.6507399988,3327812.820215675,3327812.820215675,1728423.6507399988,52.40168447175486,100,0,107.2789564568941,1011.6933655788234,904.4144091219293,77.05168577722621,95.35051206620855,94.58861696478691
1605312000,16339.56,16339.6,15708.24,16082.01,9205.93087,16631.18889100003,9205.93087,16631.18889100003,72.37835673765031,1719217.7198699987,3329506.853807408,3329506.853807408,1719217.7198699987,51.84779186067373,92.85714285714286,14.285714285714286,78.86482492787195,1002.9954402817693,924.1306153538974,72.37835673765031,87.4909976441293,93.6623161055257
1605398400,16082.01,16175.6,15796.09,15966.89,6250.09413,16329.92496000003,6250.09413,16329.92496000003,70.32516786192997,1712967.6257399986,3328882.5196173517,3328882.5196173517,1712967.6257399986,51.33346300752698,85.71428571428571,7.142857142857143,41.14936144015064,975.5673171540857,934.417955713935,70.32516786192997,83.97794270229365,88.93981747087724
1605484800,15970,16892,15879,16726.64,13948.31953,16163.968258000028,13948.31953,16163.968258000028,75.30422828752964,1726915.9452699986,3338277.050169107,3338277.050169107,1726915.9452699986,51.542663251751975,100,0,55.31948202111312,1003.5673082403264,948.2478262192133,75.30422828752964,95.4092171016102,88.9593858160111
1605571200,16726.49,17880,16575.42,17679.36,25230.2384,16371.810625000027,25230.2384,16371.810625000027,79.86629887102919,1752146.1836699985,3355746.6375816995,3355746.6375816995,1752146.1836699985,52.4069122341946,100,0,113.45647066704498,1090.0684145530195,976.6119438859745,79.86629887102919,95.3875756036221,91.59157846917539
1605657600,17679.86,18488,17205.02,17782.91,32426.0008,17203.306111000027,32426.0008,17203.306111000027,80.2924287705911,1784572.1844699986,3352531.7883231295,3352531.7883231295,1784572.1844699986,53.5201568728102,100,0,141.6527675940995,1153.6779033785988,1012.0251357844993,80.2924287705911,83.87628630230962,91.55769300251404
1605744000,17790.18,18193.29,17356,17821.58,17141.50682,17277.166215000027,17141.50682,17277.166215000027,80.45876207482917,1801713.6912899986,3354453.5516849197,3354453.5516849197,1801713.6912899986,54.553884037238966,92.85714285714286,0,145.14137718301777,1193.4518572632714,1048.3104800802537,80.45876207482917,84.04930588798473,87.77105593130555
1605830400,17821.92,18830.3,17764.76,18675.25,17901.94596,17563.947571000026,17901.94596,17563.947571000026,83.72449781127695,1819615.6372499985,3367145.563299709,3367145.563299709,1819615.6372499985,55.80397262143786,100,7.142857142857143,184.64139779024708,1279.1122273180627,1094.4708295278156,83.72449781127695,96.5699179258014,88.16517003869865
1605916800,18677.84,18980,18350,18721.21,13604.28575,17931.560835000026,13604.28575,17931.560835000026,83.88068671834705,1833219.9229999986,3369573.172512431,3369573.172512431,1833219.9229999986,57.02689504735415,100,0,192.67501647902577,1335.3146001265977,1142.639583647572,83.88068671834705,93.92240670721681,91.51387684033439
1606003200,18721.21,18773.56,17610.77,18437.66,15423.8527,18093.161210500024,15423.8527,18093.161210500024,78.85299874174851,1817796.0702999986,3376085.9198160484,3376085.9198160484,1817796.0702999986,56.408375395758426,92.85714285714286,0,159.09726474297008,1341.5111645762845,1182.4138998333144,78.85299874174851,86.97193756215678,92.48808739839176
1606089600,18437.18,18777.77,18001,18384.82,17655.67801,18277.65498100002,17655.67801,18277.65498100002,77.91576157937855,1800140.3922899987,3375878.3984902618,3375878.3984902618,1800140.3922899987,55.83724513320586,85.71428571428571,0,115.55927177240255,1326.8629895488175,1211.303717776415,77.91576157937855,84.69942826587693,88.53125751175025
1606176000,18384.82,19469,18052.02,19172.84,26623.09576,18764.070153500023,26623.09576,18764.070153500023,81.45573516801352,1826763.4880499986,3391372.620109086,3391372.620109086,1826763.4880499986,55.798287699569194,100,0,121.45906393473388,1363.1275476948322,1241.6684837600983,81.45573516801352,92.90797804576673,88.19311462460023
1606262400,19172.9,19500,18502,18721.93,20485.40806,18195.041109500024,20485.40806,18195.041109500024,74.13310507694942,1806278.0799899986,3379915.9811766124,3379915.9811766124,1806278.0799899986,55.78254884828839,100,0,78.69377718624924,1340.03570524291,1261.3419280566607,74.13310507694942,80.80346789434469,86.13695806866285
1606348800,18717.24,18915.48,16200,17170,48644.15921,19369.72872750002,48644.15921,19369.72872750002,55.60515317703646,1757633.9207799986,3366024.303615308,3366024.303615308,1757633.9207799986,52.00608304710794,92.85714285714286,0,-62.77589447949231,1182.8720599572953,1245.6479544367876,55.60515317703646,38.550963141127085,70.7541363604129
1606435200,17169.99,17475,16400,17153.95,23333.9986,19358.82448700002,23333.9986,19358.82448700002,55.4508017513876,1734299.9221799986,3375420.850586415,3375420.850586415,1734299.9221799986,48.49936480315467,85.71428571428571,7.142857142857143,-160.53613596735022,1044.9777844776,1205.5139204449501,55.4508017513876,38.12767685718507,52.494035964219016
1606521600,17155.43,17933.25,16880,17739.85,13157.96639,19423.905661500023,13157.96639,19423.905661500023,59.833965588482556,1747457.8885699986,3383746.6295568543,3383746.6295568543,1747457.8885699986,45.745821886771324,78.57142857142857,0,-186.99446295012194,971.7708417572976,1158.7653047074195,59.833965588482556,52.478596942150276,43.05241231348754
1606608000,17736.1,18359,17535.26,18202.04,8932.2646,18772.954350500022,8932.2646,18772.954350500022,62.932279530919544,1756390.1531699987,3389274.8874275074,3389274.8874275074,1756390.1531699987,43.623923987293765,71.42857142857143,0,-174.84382703271945,940.2105209165202,1115.0543479492396,62.932279530919544,64.15465341066006,51.58697573666519
1606694400,18202.02,19873.23,18201.47,19713.94,27293.49339,19463.14454250002,27293.49339,19463.14454250002,70.85275398493381,1783683.6465599986,3411367.179015702,3411367.179015702,1783683.6465599986,42.887366982842536,100,0,-71.74225322704206,1025.376531415437,1097.118784642479,70.85275398493381,95.66348962629618,70.76557999303556
1606780800,19713.94,19915.14,18109,18782.97,30442.8798,20222.42006900002,30442.8798,20222.42006900002,62.05930003153868,1753240.7667599986,3403644.119051159,3403644.119051159,1753240.7667599986,42.07630899338048,100,64.28571428571429,-72.77388973481652,1006.1514224739585,1078.925312208775,62.05930003153868,69.52550913289947,76.44788405661863
1606867200,18778.18,19340,18335,19225.63,16227.15081,19926.08996150002,16227.15081,19926.08996150002,64.32639166782887,1769467.9175699987,3416177.9380439655,3416177.9380439655,1769467.9175699987,41.323183717451435,92.85714285714286,57.142857142857146,-51.1924010158948,1014.9348109389066,1066.1272119548014,64.32639166782887,81.44053790705065,82.2098455554155
1606953600,19222.45,19625.64,18885,19448.64,14648.25116,19928.826037500017,14648.25116,19928.826037500017,65.44658617470571,1784116.1687299986,3423824.837790809,3423824.837790809,1784116.1687299986,40.84705684773294,85.71428571428571,50,-30.469652814752862,1028.0401459363602,1058.509798751113,65.44658617470571,87.4432726626722,79.4697732342075
1607040000,19446.43,19546.46,18576.05,18658.1,16382.89189,20287.67408850002,16382.89189,20287.67408850002,58.440945941044745,1767733.2768399986,3410212.3548610928,3410212.3548610928,1767733.2768399986,39.919419867032815,78.57142857142857,42.857142857142854,-75.98441389726258,963.529281379535,1039.5136952767975,58.440945941044745,66.16439757317353,78.34940271429885
1607126400,18658.09,19189.98,18501,19158.96,7082.23686,20329.28122500002,7082.23686,20329.28122500002,61.26966168014784,1774815.5136999986,3416656.863521734,3416656.863521734,1774815.5136999986,38.93901142027688,71.42857142857143,35.714285714285715,-78.04228867597737,941.9608344318258,1020.0031231078032,61.26966168014784,79.64598911481127,77.7512197835524
1607212800,19158.96,19430.25,18878,19375.6,6665.29626,19965.130061500022,6665.29626,19965.130061500022,62.45987909721505,1781480.8099599986,3422002.9802774913,3422002.9802774913,1781480.8099599986,38.2553383459881,64.28571428571429,28.571428571428573,-70.71473407091719,931.6097055191567,1002.3244395900739,62.45987909721505,85.4772633063626,77.0958833314492
1607299200,19375.6,19432.57,18901,19177.71,8977.46619,19152.491451000024,8977.46619,19152.491451000024,60.627093579955286,1772503.3437699985,3422371.995903376,3422371.995903376,1772503.3437699985,37.622754096041405,57.142857142857146,21.428571428571427,-84.18185967396789,897.097114997614,981.2789746715819,60.627093579955286,80.15068072804792,81.75797771640732
1607385600,19177.08,19299.51,18200,18316.22,15161.87705,18289.285263500024,15161.87705,18289.285263500024,53.295296103846105,1757341.4667199985,3410415.389111493,3410415.389111493,1757341.4667199985,35.86174994863543,50,14.285714285714286,-152.13425321704074,791.111158150281,943.2454113673217,53.295296103846105,56.96205257406185,74.19666553615752
1607472000,18316.22,18647.33,17639,18546.55,20667.38074,18465.578959500024,20667.38074,18465.578959500024,54.86683261124329,1778008.8474599984,3426951.4663477247,3426951.4663477247,1778008.8474599984,33.43059807450403,42.857142857142854,7.142857142857143,-180.6506339482604,717.4321189319962,898.0827528802566,54.86683261124329,63.161818935490984,66.75818407920032
1607558400,18546.55,18556.42,17905,18253.44,14899.21719,18315.442521000026,14899.21719,18315.442521000026,52.44825671619065,1763109.6302699985,3427991.223207289,3427991.223207289,1763109.6302699985,31.17309990566774,35.714285714285715,0,-215.94738866460546,628.1485170494998,844.0959057141052,52.44825671619065,52.727345141303026,57.61707221695202
1607644800,18257.18,18293.08,17580,18042.15,16953.64811,18482.910639000027,16953.64811,18482.910639000027,50.71285167826952,1746155.9821599985,3433013.0293914396,3433013.0293914396,1746155.9821599985,29.26810951563077,28.571428571428573,0,-247.9298871958082,534.183546719345,782.1134339151532,50.71285167826952,38.28983177052794,51.392998615774054
1607731200,18044.19,18955.34,18023.57,18821.28,8616.18695,18142.527351500026,8616.18695,18142.527351500026,56.436911057548805,1754772.1691099985,3439149.879117625,3439149.879117625,1754772.1691099985,27.751793383725058,21.428571428571427,0,-212.3871257741289,516.6295266974921,729.016652471621,56.436911057548805,54.03717834512664,48.35145175231927
1607817600,18821.28,19421.03,18730,19166.65,10624.21489,17790.954195500028,10624.21489,17790.954195500028,58.72521957753533,1765396.3839999984,3441952.182415601,3441952.182415601,1765396.3839999984,26.891069734620103,14.285714285714286,0,-163.5815265174217,524.5397443248439,688.1212708422656,58.72521957753533,67.94667557405559,53.42456189657013
1607904000,19166.65,19349.98,18967.68,19272.37,9102.38393,16914.918604000028,9102.38393,16914.918604000028,59.42777718355235,1774498.7679299985,3447358.850850925,3447358.850850925,1774498.7679299985,26.091826346165504,7.142857142857143,78.57142857142857,-123.94257535588201,533.1930516474131,657.1356270032951,59.42777718355235,72.47402725318393,64.81929372412213
1607990400,19272.37,19565,19051.27,19444.6,15345.22643,16657.909522500027,15345.22643,16657.909522500027,60.60425256418813,1789843.9943599985,3455511.3290973576,3455511.3290973576,1789843.9943599985,25.60684516954142,0,71.42857142857143,-87.60003793230237,547.6355795879172,635.2356175202195,60.60425256418813,91.1499579593672,77.19022026220232
1608076800,19443.19,21569.94,19300,21359.65,33350.24947,15893.214035500027,33350.24947,15893.214035500027,70.75783959650812,1823194.2438299984,3482682.363292023,3482682.363292023,1823194.2438299984,26.88663585452446,100,64.28571428571429,56.193594418345924,705.477610543152,649.284016124806,70.75783959650812,94.72949467911805,86.11782663055646
1608163200,21360.5,23776.94,21252.01,22826.48,53602.36394,17406.632302500027,53602.36394,17406.632302500027,75.88465791841728,1876796.6077699985,3495929.6260368116,3495929.6260368116,1876796.6077699985,29.133693045042257,100,57.142857142857146,231.06516173528496,938.1154682939123,707.0503065586273,75.88465791841728,84.66243016714702,90.1806276018775
1608249600,22826.37,23280,22329,23137.76,24829.25011,17990.196488500027,24829.25011,17990.196488500027,76.8136807791258,1901625.8578799984,3513331.510141246,3513331.510141246,1901625.8578799984,31.220246150523067,92.85714285714286,50,341.97757442135185,1134.522274585317,792.5447001639652,76.8136807791258,89.68555448334178,89.69249310986902
1608336000,23138.89,24200,22770,23849.99,20577.67893,18572.46720500003,20577.67893,18572.46720500003,78.8238545995731,1922203.5368099983,3523835.9115855265,3523835.9115855265,1922203.5368099983,33.49275688110272,100,42.857142857142854,431.7956723730813,1332.2892906303168,900.4936182572355,78.8238545995731,94.7128398791541,89.68694150988104
1608422400,23850,24300,23100,23476.51,14963.43216,17955.96414350003,14963.43216,17955.96414350003,75.1448301034484,1907240.1046499982,3518262.2824964626,3518262.2824964626,1907240.1046499982,35.63729132127576,100,35.714285714285715,433.41222393801945,1442.2588981797599,1008.8466742417404,75.1448301034484,87.7456845238095,90.71469296210188
1608508800,23476.51,24118.75,21913.84,22729.4,25728.65296,17720.252801500028,25728.65296,17720.252801500028,68.27941666691727,1881511.4516899982,3511566.84196514,3511566.84196514,1881511.4516899982,35.96440077240558,92.85714285714286,28.571428571428573,354.82898481053417,1452.382905254908,1097.553920444374,68.27941666691727,76.6279761904762,86.36216686448002
1608595200,22729.4,23839.78,22380.05,23823.27,18597.66575,17838.778548500028,18597.66575,17838.778548500028,72.27359134769776,1900109.117439998,3529743.8169551603,3529743.8169551603,1900109.117439998,36.26814526274041,85.71428571428571,21.428571428571427,346.77584955702196,1531.0237323906513,1184.2478828336293,72.27359134769776,92.90580357142858,85.75982142857151
1608681600,23824.13,24090,22600,23228.35,23412.13625,18276.972803000026,23412.13625,18276.972803000026,67.30949968296235,1876696.981189998,3526078.0106550762,3526078.0106550762,1876696.981189998,36.69404092465379,78.57142857142857,14.285714285714286,274.7867708883907,1527.7313464441177,1252.944575555727,67.30949968296235,84.05282738095237,84.52886904761912
1608768000,23226.18,23785,22712.89,23717.96,16440.76741,18279.866579000023,16440.76741,18279.866579000023,69.18533211992889,1893137.7485999982,3540462.666197513,3540462.666197513,1893137.7485999982,37.08951546785907,71.42857142857143,7.142857142857143,235.08354429801193,1546.799005928242,1311.71546163023,69.18533211992889,91.33869047619046,89.43244047619055
1608854400,23718.61,24770.95,23416,24704.71,15792.4903,18715.379251000024,15792.4903,18715.379251000024,72.59801572335067,1908930.2388999981,3554711.04851202,3554711.04851202,1908930.2388999981,38.00721798687822,100,0,248.88828349407004,1622.8258159978177,1373.9375325037477,72.59801572335067,99.01828561604651,91.4699344910632
1608940800,24704.71,26822,24490.01,26475.35,24782.45453,19621.237164500024,24782.45453,19621.237164500024,77.4286475298494,1933712.6934299981,3572125.685973487,3572125.685973487,1933712.6934299981,39.68217561455586,100,0,344.9658735306232,1805.1448744170266,1460.1790008864034,77.4286475298494,95.71613939693523,95.35770516305747
1609027200,26482.64,28387,25772.55,26258.65,33627.02181,20853.714945500025,33627.02181,20853.714945500025,75.67047414002828,1900085.671619998,3551003.0878869016,3551003.0878869016,1900085.671619998,41.67526394584472,100,0,359.9603035370101,1910.129380307666,1550.169076770656,75.67047414002828,77.40441985196385,90.71294828831527
1609113600,26255.16,27477,26086.19,27040.36,21265.72381,21158.907283500022,21265.72381,21158.907283500022,77.64267568952111,1921351.3954299982,3558916.2104869615,3558916.2104869615,1921351.3954299982,43.52598882489866,92.85714285714286,0,386.24311826822895,2032.972974605942,1646.729856337713,77.64267568952111,85.57541831222626,86.23199252037519
1609200000,27039.39,27396.77,25833.73,27366.35,20668.11887,21158.944190000024,20668.11887,21158.944190000024,78.42800403717072,1942019.514299998,3578779.8404430174,3578779.8404430174,1942019.514299998,44.89869977730237,85.71428571428571,0,388.2601733236504,2132.055072992276,1743.7948996686257,78.42800403717072,88.76802024870693,83.9159528042991
1609286400,27366.35,29018.26,27311.73,28897.42,28181.51126,21823.058893500023,28181.51126,21823.058893500023,81.68243231572717,1970201.0255599981,3602970.2659082664,3602970.2659082664,1970201.0255599981,46.61655895372842,100,0,450.9826498025611,2307.523211921827,1856.540562119266,81.68243231572717,98.44403669724771,90.92915841939373
1609372800,28897.42,29321.9,28000,28990.08,28813.90137,22416.07155650002,28813.90137,22416.07155650002,81.86078709247809,1999014.9269299982,3617318.5817535017,3617318.5817535017,1999014.9269299982,48.283785477953245,100,0,455.6422460139902,2426.093369636754,1970.4511236227636,81.86078709247809,95.52082461535139,94.24429385376875
1609459200,28990.08,29688.88,28700,29412.84,22211.26707,23095.825562500024,22211.26707,23095.825562500024,82.68896975060973,2021226.1939999983,3627129.56130226,3627129.56130226,2021226.1939999983,49.918999725123356,100,21.428571428571427,443.6925999862515,2525.0668736055777,2081.3742736193262,82.68896975060973,96.44966456764209,96.80484196008048
1609545600,29413.29,33300,29039,32225.91,46675.26097,24898.37786650002,46675.26097,24898.37786650002,86.95647454263079,2067901.4549699982,3650273.523959532,3650273.523959532,2067901.4549699982,52.056499164000115,100,14.285714285714286,573.491757702971,2798.2389707480397,2224.7472130450687,86.95647454263079,90.56670554427481,94.17906490908952
1609632000,32222.88,34810,32008.62,33080.66,36951.73089,26290.845214500023,36951.73089,26290.845214500023,87.93011266894085,2104853.185859998,3641603.378276334,3641603.378276334,2104853.185859998,54.21302372896291,100,7.142857142857143,659.0495220169287,3048.5591155662296,2389.509593549301,87.93011266894085,86.59027183285569,91.20221398159094
1609718400,33082.84,33666.99,27678,32019.99,46045.40397,27825.854091500027,46045.40397,27825.854091500027,79.95437812648095,2058807.7818899981,3662323.3833598476,3662323.3833598476,2058807.7818899981,52.71123742257132,92.85714285714286,0,588.6528218591002,3125.3256208731764,2536.672799014076,79.95437812648095,77.55413336336834,84.90370358016638
1609804800,32020.22,34499.67,29891.13,34030.64,42282.58352,28272.47079400003,42282.58352,28272.47079400003,83.08630998276692,2101090.365409998,3695999.423311435,3695999.423311435,2101090.365409998,51.56868947128934,85.71428571428571,0,618.8600044409386,3310.2478045652497,2691.387800124311,83.08630998276692,93.61703521703522,85.92048013775316
1609891200,34043.91,37000,33352.54,36859.26,45744.11759,27879.558476500028,45744.11759,27879.558476500028,86.32363477572049,2146834.482999998,3738213.3982215337,3738213.3982215337,2146834.482999998,51.16697607358075,100,0,761.3306686172718,3643.051135895901,2881.7204672786293,86.32363477572049,99.0149162426831,90.06202827436232
1609977600,36859.26,40425,36200,39505.56,50346.31998,29155.411970000026,50346.31998,29155.411970000026,88.53461859932663,2197180.8029799983,3766647.0931400373,3766647.0931400373,2197180.8029799983,51.477549462081264,100,0,953.3268974518714,4073.379089093469,3120.0521916415973,88.53461859932663,94.59439120465635,95.74211422145832
1610064000,39510.55,41986.37,36565.08,40665.15,48522.49917,30552.65298200002,48522.49917,30552.65298200002,89.34730750977802,2245703.3021499985,3791518.8020540695,3791518.8020540695,2245703.3021499985,52.02003948747153,100,0,1069.2488473585481,4456.613250839782,3387.364403481234,89.34730750977802,92.44860073752483,95.35263606162152
1610150400,40642.15,41406.94,38800,40257.43,27152.98556,31162.13065200002,27152.98556,31162.13065200002,87.01193118854357,2218550.3165899985,3794725.990295316,3794725.990295316,2218550.3165899985,52.523780225333915,92.85714285714286,0,1028.9529957828554,4673.555648209804,3644.602652426948,87.01193118854357,89.3366276423446,92.12653986150868
1610236800,40257.43,41452.12,34444,38171.57,43736.58493,32062.527250500025,43736.58493,32062.527250500025,76.05892331371108,2174813.7316599987,3797515.7724616327,3797515.7724616327,2174813.7316599987,50.65592845659743,85.71428571428571,0,783.4150614329287,4623.871479218109,3840.4564177851803,76.05892331371108,76.38280801156961,86.05601213047977
1610323200,38168.89,38273.88,30100,35452.59,102503.17099,36257.80251250002,102503.17099,36257.80251250002,64.63695341963444,2072310.5606699986,3829259.1154917465,3829259.1154917465,2072310.5606699986,47.289122276962594,78.57142857142857,7.142857142857143,379.9170693410142,4315.352754461448,3935.435685120434,64.63695341963444,59.549770192364804,75.0897352820931
1610409600,35456.89,36604.51,32500,34038.98,48227.64205,37498.577802500025,48227.64205,37498.577802500025,59.62371723678672,2024082.9186199987,3817197.2406403203,3817197.2406403203,2024082.9186199987,44.162802253015954,71.42857142857143,0,-18.995439287136833,3911.691386011513,3930.6868252986496,59.62371723678672,45.84269188204959,60.591756695328094
1610496000,34035.53,37888,32309.04,37393.66,39608.7518,38656.97702200002,39608.7518,38656.97702200002,66.30306250619347,2063691.6704199987,3849786.6948060617,3849786.6948060617,2063691.6704199987,41.661912340732506,64.28571428571429,0,-89.7777801881748,3818.464600063431,3908.242380251606,66.30306250619347,67.90193432235819,57.76479879892429
1610582400,37393.67,40127.66,36751.11,39125.14,31868.77514,39460.79126400003,31868.77514,39460.79126400003,69.14062688271162,2095560.4455599987,3862731.370226909,3862731.370226909,2095560.4455599987,39.980915498868434,57.142857142857146,28.571428571428573,-54.56817181088854,3840.0321654879954,3894.600337298884,69.14062688271162,80.00310307882728,64.58257642774511
1610668800,39123.05,39697,34298.93,36754.67,36421.07363,40042.72221900003,36421.07363,40042.72221900003,61.50464523389553,2059139.3719299987,3859448.3208745252,3859448.3208745252,2059139.3719299987,37.53944495629381,50,21.428571428571427,-216.42310307878552,3624.071458450402,3840.4945615291876,61.50464523389553,63.43608671008644,70.44704137042407
1610755200,36754.6,37948,35372.59,36006.94,20861.43958,39404.44310750003,20861.43958,39404.44310750003,59.280621898654694,2038277.9323499987,3848863.6560197715,3848863.6560197715,2038277.9323499987,35.27236516676023,42.857142857142854,14.285714285714286,-389.25681925879053,3353.9235374556993,3743.18035671449,59.280621898654694,58.21026434178037,67.21648471023147
1610841600,36004.8,36860,33850.03,35820,19182.0639,39300.26011200003,19182.0639,39300.26011200003,58.709039934387825,2019095.8684499988,3854790.2081000526,3854790.2081000526,2019095.8684499988,32.866814217697545,35.714285714285715,7.142857142857143,-523.2360934090052,3089.1352399532334,3612.3713333622386,58.709039934387825,56.903756332831755,59.5167024615663
1610928000,35820.01,37402,34736.46,36624.23,16609.65536,39097.336936500025,16609.65536,39097.336936500025,60.47468661383225,2035705.5238099988,3861706.899445746,3861706.899445746,2035705.5238099988,30.59465409379526,28.571428571428573,0,-561.392026346563,2910.631300429035,3472.023326775598,60.47468661383225,55.66735343821207,56.92712470427483
1611014400,36624.23,37857,35895.11,35917.28,18904.79354,38633.501050500025,18904.79354,38633.501050500025,58.12190418524047,2016800.7302699988,3843229.36663166,3843229.36663166,2016800.7302699988,28.64768482018504,21.428571428571427,0,-632.6479995863515,2681.2133272926585,3313.86132687901,58.12190418524047,48.940761561351344,53.83729044413183
1611100800,35921.91,36415.34,33387.01,35503.09,25445.72251,38465.09210750002,25445.72251,38465.09210750002,56.72935175251772,1991355.0077599988,3853344.619635531,3853344.619635531,1991355.0077599988,27.251437472103596,14.285714285714286,35.714285714285715,-700.7898889492526,2437.8739656924445,3138.663854641697,56.72935175251772,45.456182164950235,50.02143238817132
1611187200,35498.85,35628.24,30011,30855.95,50473.12825,39878.18516650003,50473.12825,39878.18516650003,43.993430139026174,1940881.8795099987,3818055.912814859,3818055.912814859,1940881.8795099987,26.919433985217072,7.142857142857143,100,-1031.947558573257,1848.7294064251255,2880.6769649983826,43.993430139026174,7.055731889703622,33.81755853866851
1611273600,30855.9,33867,28732,32984.93,48155.7361,39952.20892300002,48155.7361,39952.20892300002,49.57827096137455,1989037.6156099988,3849667.6449648193,3849667.6449648193,1989037.6156099988,26.927055230327092,0,100,-1075.81042617305,1535.9139322820702,2611.72435845512,49.57827096137455,33.434668855325256,28.648860969993148
1611360000,32982.66,33488.79,31432.19,32112.01,16139.8291,38911.61383350002,16139.8291,38911.61383350002,47.48735143620574,1972897.7865099988,3844198.027494462,3844198.027494462,1972897.7865099988,26.934132100786396,7.142857142857143,92.85714285714286,-1126.42536912868,1203.6926470442704,2330.1180161729503,47.48735143620574,26.572154979669985,22.354185241566395
1611446400,32110,33086.53,30931.21,32288.56,13618.81534,37290.28440200002,13618.81534,37290.28440200002,47.9653390380166,1986516.6018499988,3847732.5805654167,3847732.5805654167,1986516.6018499988,27.072589344453927,0,85.71428571428571,-1109.0769882455588,943.7717808660018,2052.8487691115606,47.9653390380166,31.209776353453858,30.405533396149806
1611532800,32293.18,34888,31920.8,32261.87,23045.67722,36328.43908700002,23045.67722,36328.43908700002,47.894364486179505,1963470.9246299989,3829984.954794207,3829984.954794207,1963470.9246299989,26.37969568647683,21.428571428571427,78.57142857142857,-1060.4824346363034,727.2457258161812,1787.7281604524846,47.894364486179505,30.975564381527686,29.58583190488395
1611619200,32260.52,32960.37,30830,32510.82,23535.85317,35218.02586600002,23535.85317,35218.02586600002,48.65749779694045,1987006.7777999989,3843587.7514598686,3843587.7514598686,1987006.7777999989,26.060852262454464,14.285714285714286,71.42857142857143,-974.8430372633807,569.1743638732587,1544.0174011366394,48.65749779694045,33.16016799378008,31.781836242920647
1611705600,32510.82,32584.62,29156,30407.13,46207.09968,35011.06485100002,46207.09968,35011.06485100002,42.93504834351488,1940799.678119999,3831103.309072096,3831103.309072096,1940799.678119999,26.2294530117749,7.142857142857143,64.28571428571429,-1018.3921323515528,271.0272356971982,1289.419368048751,42.93504834351488,14.699719015835859,26.278483797047983
1611792000,30414.11,34000,29902.14,33488.99,36007.07716,34385.293750500015,36007.07716,34385.293750500015,51.8660391258697,1976806.755279999,3858130.10066864,3858130.10066864,1976806.755279999,25.73921809604472,0,57.142857142857146,-807.3803479124788,280.1939331581525,1087.5742810706313,51.8660391258697,43.38340173278612,30.41442958080079
1611878400,33487.92,38570.13,31990,34262.11,72641.09119,36659.69903200002,72641.09119,36659.69903200002,53.81864911027438,2049447.846469999,3835654.750794909,3835654.750794909,2049447.846469999,24.196268053867183,0,50,-593.374532303478,345.8561156912838,939.2306479947617,53.81864911027438,56.2109872506259,38.0980359997494
1611964800,34262.11,34900,32852.86,34315.63,21362.16611,35540.97809100002,21362.16611,35540.97809100002,53.95789198609126,2070810.0125799992,3844820.96644749,3844820.96644749,2070810.0125799992,22.763528728988042,92.85714285714286,42.857142857142854,-433.2814247400004,397.6288670697613,830.9102918097617,53.95789198609126,56.75499307287055,52.116460685427626
1612051200,34315.63,34387.75,32200,33137.74,16436.41201,31237.64014200002,16436.41201,31237.64014200002,50.35909319259938,2054373.600569999,3842474.903881674,3842474.903881674,2054373.600569999,21.19813109239429,85.71428571428571,35.714285714285715,-392.9702767474331,339.6974458754703,732.6677226229034,50.35909319259938,44.78229094350246,52.58275708899975
1612137600,33137.75,34728.57,32333,33533.19,21975.42815,29925.02944700002,21975.42815,29925.02944700002,51.52796103053454,2076349.0287199991,3842519.0277475608,3842519.0277475608,2076349.0287199991,19.86814191767823,78.57142857142857,28.571428571428573,-328.54677549922155,321.9842532488765,650.531028748098,51.52796103053454,48.80185563719938,50.113046551190905
1612224000,33534.39,36000,33450,35512.67,19995.85343,28944.38452850002,19995.85343,28944.38452850002,56.98759637699614,2096344.882149999,3854872.0739210574,3854872.0739210574,2096344.882149999,19.089059294012138,71.42857142857143,21.428571428571427,-150.54938617785888,462.3442960257744,612.8936822036333,56.98759637699614,68.9223460149439,54.16883086521536
1612310400,35513,37723.72,35393.8,37678.37,23781.98375,28540.04495900002,23781.98375,28540.04495900002,62.02699974708077,2120126.865899999,3877728.2636840856,3877728.2636840856,2120126.865899999,18.93334446116289,64.28571428571429,14.285714285714286,101.53025648117818,739.806502805106,638.2762463239278,62.02699974708077,90.93567578391426,69.55329247868596
1612396800,37688.42,38769,36156.45,36975,31699.37745,28303.96015000002,31699.37745,28303.96015000002,59.585286447000954,2088427.4884499991,3865892.6403530096,3865892.6403530096,2088427.4884499991,19.108884287922372,100,7.142857142857143,203.5000361891456,892.6512915603598,689.1512553712142,59.585286447000954,82.12613330676497,80.66138503520783
1612483200,36976.59,38349,36605.87,38311.49,17842.71613,28153.02397750002,17842.71613,28153.02397750002,62.59811193145213,2106270.204579999,3882967.4501512544,3882967.4501512544,2106270.204579999,19.27188555562761,92.85714285714286,0,335.75371953012825,1108.8434047838746,773.0896852537463,62.59811193145213,95.24071569749296,89.43417492939085
1612569600,38327.09,41000,38250,39265.43,27102.82027,28549.061796000024,27102.82027,28549.061796000024,64.62518179658969,2133373.024849999,3875879.914817084,3875879.914817084,2133373.024849999,20.192093193687523,100,28.571428571428573,454.8771124157428,1341.6860757734248,886.808963357682,64.62518179658969,85.3548632218845,87.57390407538092
1612656000,39266.1,39737.83,37371.35,38871.42,20297.88686,28733.473371000022,20297.88686,28733.473371000022,63.10392534059079,2113075.1379899993,3881314.974055999,3881314.974055999,2113075.1379899993,20.606707686808996,92.85714285714286,21.428571428571427,472.46627162839275,1477.391802893173,1004.9255312647803,63.10392534059079,82.02819993245524,87.54125961727767
1612742400,38871.43,46750,38057.01,46448.1,47934.02472,30184.934930000025,47934.02472,30184.934930000025,75.19558715113246,2161009.1627099994,3925919.584601367,3925919.584601367,2161009.1627099994,22.503282232666336,100,14.285714285714286,933.0876560408562,2171.2851013158506,1238.1974452749944,75.19558715113246,98.28407411617596,88.55571242350534
1612828800,46453.66,48200,45020,46514.73,36418.8081,30733.589209500024,36418.8081,30733.589209500024,75.2723346962311,2197427.9708099994,3923737.433753765,3923737.433753765,2197427.9708099994,24.490351967688945,100,7.142857142857143,1165.8459804702304,2695.5049208627825,1529.658940392552,75.2723346962311,91.15065112371352,90.48764172411501
1612915200,46514.73,47349.99,43706.86,44850,25818.02588,29500.834091000026,25818.02588,29500.834091000026,69.48737763339041,2171609.9449299993,3914121.7493243655,3914121.7493243655,2171609.9449299993,25.74314438271714,92.85714285714286,0,1130.43402811853,2942.7014755407145,1812.2674474221844,69.48737763339041,81.69184811775803,90.37552445254926
1613001600,44850,48690,44011,47997.91,26222.6191,28404.178241000027,26222.6191,28404.178241000027,73.61652131244651,2197832.564029999,3932586.9790450456,3932586.9790450456,2197832.564029999,27.143140219090416,100,0,1233.349448441878,3353.954257974532,2120.604809532654,73.61652131244651,95.85574850299405,89.56608258148863
1613088000,47993.6,48912,46300,47408.34,23503.17025,28772.345298500026,23503.17025,28772.345298500026,71.66056810716455,2174329.393779999,3929029.8300162437,3929029.8300162437,2174329.393779999,28.4825492147389,100,0,1176.2424946791966,3590.90792788165,2414.665433202453,71.66056810716455,91.00251316419336,89.51670326164856
1613174400,47408.34,48199,46300,47232.45,12020.8918,28692.449121500027,12020.8918,28692.449121500027,71.05402411716891,2162308.5019799992,3928813.973033421,3928813.973033421,2162308.5019799992,29.726286139269632,92.85714285714286,7.142857142857143,1045.5494544622916,3721.6022512803174,2676.052796818026,71.05402411716891,89.9500359023456,92.26943252317777
1613260800,47240.75,49700,47100.13,48680.69,15146.56693,28297.49360700003,15146.56693,28297.49360700003,73.07482994117382,2177455.0689099994,3932083.7560185175,3932083.7560185175,2177455.0689099994,31.16467728835252,100,0,976.8503896200032,3897.11578384303,2920.2653942230268,73.07482994117382,94.1307652444291,91.69443810365613
1613347200,48667.23,49093.44,45768.46,47936.37,19432.16695,28092.30929600003,19432.16695,28092.30929600003,70.3562451913011,2158022.9019599995,3937991.4040764724,3937991.4040764724,2158022.9019599995,31.799223362075246,92.85714285714286,0,808.4587694039783,3930.8388559779996,3122.3800865740213,70.3562451913011,89.14689230769233,91.07589781815578
1613433600,47935.66,50645,47051.22,49158.71,23053.21991,26934.615307500026,23053.21991,26934.615307500026,72.18624761748634,2181076.1218699994,3941976.2501739217,3941976.2501739217,2181076.1218699994,32.71363930077463,100,0,710.0741594849023,4009.9727859301493,3299.898626445247,72.18624761748634,90.2546029164918,91.1774201562045
1613520000,49141.43,52640.35,48942.87,52170.01,25675.18586,26418.020742500026,25675.18586,26418.020742500026,76.10053970847402,2206751.3077299995,3961119.3834373467,3961119.3834373467,2206751.3077299995,33.93931210903151,100,0,773.2749164041538,4266.492271950439,3493.2173555462855,76.10053970847402,97.146670387469,92.18272187055113
1613606400,52170.01,52549.99,50875,51601.73,15689.417,23570.437033000027,15689.417,23570.437033000027,73.98448291249426,2191061.8907299996,3959044.340274098,3959044.340274098,2191061.8907299996,35.07743685955575,92.85714285714286,0,704.2382797165437,4373.515205191965,3669.276925475421,73.98448291249426,93.5225838318424,93.64128571193449
1613692800,51596,56370.05,50725,55983.56,27961.49621,23900.403538000028,27961.49621,23900.403538000028,78.86457853625753,2219023.3869399996,3983177.052444912,3983177.052444912,2219023.3869399996,36.75884614404066,100,0,870.2361755012207,4757.072144851947,3886.8359693507264,78.86457853625753,97.96570291651531,96.211652378609
1613779200,55983.57,57563.57,54000.1,55923.52,22137.83623,24185.474749000026,22137.83623,24185.474749000026,78.64688414826958,2196885.5507099996,3984937.470984284,3984937.470984284,2196885.5507099996,38.48402894805569,100,7.142857142857143,889.394068212001,4998.578554615728,4109.184486403727,78.64688414826958,91.87781234554693,94.45536636463497
1613865600,55921.44,58367,55531.23,57489.16,13530.44874,23763.22577850003,13530.44874,23763.22577850003,80.1830495462633,2210415.9994499995,3990090.9574728166,3990090.9574728166,2210415.9994499995,40.19386184017424,100,0,917.2311940945565,5255.723479021923,4338.492284927366,80.1830495462633,95.67779206193605,95.17376910799952
1613952000,57489.16,57577.69,46616,54142.13,49449.18004,25235.89210900003,49449.18004,25235.89210900003,68.78967533653655,2160966.8194099995,4008543.890587712,4008543.890587712,2160966.8194099995,38.116936142083766,92.85714285714286,0,633.4433491118125,5130.296471317131,4496.853122205319,68.78967533653655,71.18124383532488,86.24561608093605
1614038400,54125.67,54206.22,44888.08,48899.99,72300.59998,27661.822920500028,72300.59998,27661.822920500028,55.49056392249697,2088666.2194299996,3998501.1017300524,3998501.1017300524,2088666.2194299996,35.69744012702853,85.71428571428571,7.142857142857143,46.82639893825581,4555.386120878138,4508.559721939882,55.49056392249697,35.423467988709504,67.42750129532357
1614124800,48899.99,51415.41,47002,49737.82,30732.16378,27613.46223700002,30732.16378,27613.46223700002,56.92396287339872,2119398.3832099997,4005869.938451977,4005869.938451977,2119398.3832099997,33.450765255905814,78.57142857142857,0,-310.9437830812749,4119.879993088289,4430.823776169564,56.92396287339872,39.891473948174976,48.832061924069876
1614211200,49737.81,52107.83,46700,47058.48,28011.21856,28121.887358500022,28011.21856,28121.887358500022,51.240830704340574,2091387.1646499997,3981572.3949259142,3981572.3949259142,2091387.1646499997,31.55568699553455,71.42857142857143,0,-730.2712090623099,3517.984764841676,4248.255973903986,51.240830704340574,16.102180293376634,30.472374076753795
1614297600,47063.9,48464.64,44150,46326.2,36048.6327,28569.17798000002,36048.6327,28569.17798000002,49.77809804970678,2055338.5319499997,3981887.878111244,3981887.878111244,2055338.5319499997,29.56936556226238,64.28571428571429,100,-1040.278430103831,2947.9079362741977,3988.1863663780287,49.77809804970678,15.307026798902701,23.766893680151526
1614384000,46319.79,48356.86,45055,46180.75,16290.29538,28368.798406000024,16290.29538,28368.798406000024,49.47598846026223,2039048.2365699997,3976705.7460234705,3976705.7460234705,2039048.2365699997,27.72492423136679,57.142857142857146,92.85714285714286,-1225.693649156919,2456.0693049318797,3681.762954088799,49.47598846026223,14.283955827530422,15.23105430660334
1614470400,46169.92,46656,43016,45231.75,22745.62046,27109.378193000022,22745.62046,27109.378193000022,47.45240281274146,2016302.6161099998,3981651.6687141545,3981651.6687141545,2016302.6161099998,26.594442027486014,50,100,-1371.7843229468835,1967.0325504051943,3338.816873352078,47.45240281274146,14.433913100123771,14.67496524218572
1614556800,45231.74,49829,45042.13,49639.4,25068.26494,26541.85103500002,25068.26494,26541.85103500002,56.37665179911582,2041370.8810499997,4004734.1086651227,4004734.1086651227,2041370.8810499997,24.838302151116665,42.857142857142854,92.85714285714286,-1140.5933562411678,1913.075178050618,3053.668534291786,56.37665179911582,43.146374829001374,23.95474791888528
1614643200,49635.3,50250,47075.11,48511.6,17063.57728,26104.128605000027,17063.57728,26104.128605000027,53.85627872636488,2024307.3037699996,4003111.4809153094,4003111.4809153094,2024307.3037699996,23.329728018313382,35.714285714285715,85.71428571428571,-1035.708823134728,1759.032505373376,2794.741328508104,53.85627872636488,35.799622174451166,31.126636701192194
1614729600,48502.18,52666,48161.75,50360,21301.49165,25858.072232500024,21301.49165,25858.072232500024,57.231038108325855,2045608.7954199996,4002601.9097935273,4002601.9097935273,2045608.7954199996,22.598320439917742,28.571428571428573,78.57142857142857,-823.1942152205725,1765.7485594823884,2588.942774702961,57.231038108325855,47.840531561461795,42.26217618830487
1614816000,50370.33,51798.33,47502,48368.52,23386.99392,25852.263416000023,23386.99392,25852.263416000023,52.754385070224714,2022221.8014999996,3988648.687474665,3988648.687474665,2022221.8014999996,21.694362888670558,21.428571428571427,71.42857142857143,-797.5354732771975,1592.023433106464,2389.5589063836615,52.754385070224714,34.8675656309035,39.502573122272246
1614902400,48370.97,49473.99,46219.32,48769.47,25468.19469,26524.628560500023,25468.19469,26524.628560500023,53.54229846500985,2047689.9961899996,4003090.97015331,4003090.97015331,2047689.9961899996,20.422603823773482,14.285714285714286,64.28571428571429,-735.8424036606348,1469.7559018078682,2205.598305468503,53.54229846500985,37.479447592990695,40.06251492845209
1614988800,48766.01,49210,47077,48909.84,11877.85194,26361.192811000023,11877.85194,26361.192811000023,53.832581286976286,2059567.8481299996,4011625.8722214764,4011625.8722214764,2059567.8481299996,19.24168469208334,7.142857142857143,57.142857142857146,-669.7502413657589,1368.4105037613044,2038.1607451270634,53.832581286976286,38.39385056348118,36.91362126245855
1615075200,48909.84,51459,48909.83,50978.61,13965.16917,26087.84292200002,13965.16917,26087.84292200002,57.99797833249514,2073533.0172999995,4020327.5810356927,4020327.5810356927,2073533.0172999995,18.83632680927497,0,50,-479.77299418172515,1438.444502399907,1918.217496581632,57.99797833249514,54.681908487270356,43.51840221458084
1615161600,50976.22,52425,49328.62,52415.23,18856.30114,25877.996983500023,18856.30114,25877.996983500023,60.652878298256624,2092389.3184399996,4039064.8876968897,4039064.8876968897,2092389.3184399996,18.734664353783607,0,42.857142857142854,-261.35473354249416,1591.5240796535145,1852.8788131960087,60.652878298256624,83.9950420992617,59.02360038333783
1615248000,52413.17,54936,51845.01,54916.38,21177.16391,25653.09588600002,21177.16391,25653.09588600002,64.82188887658333,2113566.4823499997,4059973.208319843,4059973.208319843,2113566.4823499997,19.293725934317038,100,35.714285714285715,31.971455162875372,1892.8431321496028,1860.8716769867274,64.82188887658333,99.83540268456373,79.50411775703202
1615334400,54921.61,57402.14,53025,55890.69,28326.09202,26284.929637000023,28326.09202,26284.929637000023,66.31897714050979,2141892.5743699996,4068736.996285767,4068736.996285767,2141892.5743699996,20.36299267560095,100,28.571428571428573,259.35960722506024,2185.0711860180527,1925.7115787929924,66.31897714050979,89.49370713756437,91.10805064046336
1615420800,55888.7,58113,54283,57815.47,24369.22649,26105.316151000025,24369.22649,26105.316151000025,69.11529754516873,2166261.8008599994,4089320.021231344,4089320.021231344,2166261.8008599994,21.50392779223794,100,21.428571428571427,493.564654599993,2542.667397042984,2049.102742442991,69.11529754516873,98.02921110154335,95.78610697455724
1615507200,57820.15,58065.92,55050,57225.91,21760.55241,26086.451960000024,21760.55241,26086.451960000024,67.27294104714437,2144501.2484499994,4098958.84519369,4098958.84519369,2144501.2484499994,22.56336754340086,92.85714285714286,14.285714285714286,558.1807457738623,2746.828674660319,2188.6479288864566,67.27294104714437,94.12406438365241,93.88232754092013
1615593600,57220.84,61788.45,56083.74,61178.5,22301.30032,26524.994539000025,22301.30032,26524.994539000025,72.55497878779214,2166802.5487699993,4116491.2166355583,4116491.2166355583,2166802.5487699993,24.27795823892322,100,7.142857142857143,801.7116772940217,3190.7875255039835,2389.075848209962,72.55497878779214,96.75082368044663,96.30136638854755
1615680000,61181.38,61680,58950,58972.7,13581.98192,24731.634633000023,13581.98192,24731.634633000023,66.13956189705743,2153220.566849999,4103135.1035723966,4103135.1035723966,2153220.566849999,25.870078170479694,92.85714285714286,0,749.7753449805032,3326.2950294355905,2576.5196844550874,66.13956189705743,83.18585814674508,91.35358207028146
1615766400,58972.71,60601.07,54568,55636.15,31651.40627,22699.17494750002,31651.40627,22699.17494750002,57.81243615661984,2121569.160579999,4082691.4073429895,4082691.4073429895,2121569.160579999,25.464770278670297,85.71428571428571,0,441.4977311717471,3128.391848419771,2686.894117248024,57.81243615661984,60.483983369655235,80.1402217322824
1615852800,55629.08,56970,53221,56927.11,24432.39319,22384.18641800002,24432.39319,22384.18641800002,59.91530517362807,2146001.553769999,4106564.7686077193,4106564.7686077193,2146001.553769999,24.605780246634495,78.57142857142857,21.428571428571427,283.021405055847,3040.670873567833,2757.649468511986,59.91530517362807,68.775776167326,70.81520589457553
1615939200,56924.26,58996.38,54138.01,58925.54,22687.5887,22118.004925000023,22687.5887,22118.004925000023,62.99069087493162,2168689.1424699994,4128590.7408464337,4128590.7408464337,2168689.1424699994,24.324246966273908,71.42857142857143,14.285714285714286,271.24923440695056,3096.711011520674,2825.4617771137237,62.99069087493162,81.61162505547838,70.29046153081997
1616025600,58925.54,60100,56996.15,57644.95,21459.50731,21388.54865550002,21459.50731,21388.54865550002,59.82333073221213,2147229.6351599996,4116102.6260603815,4116102.6260603815,2147229.6351599996,24.32731078861452,64.28571428571429,7.142857142857143,142.16787502629722,3003.1716208965954,2861.003745870298,59.82333073221213,73.38643842013009,74.59127988097823
1616112000,57644.95,59461.99,56260,58039.66,16429.64439,21395.516106000017,16429.64439,21395.516106000017,60.482897664535614,2163659.2795499996,4117936.11237042,4117936.11237042,2163659.2795499996,24.041983674516327,57.142857142857146,0,52.9157498097361,2927.148433132468,2874.232683322732,60.482897664535614,74.51787553232352,76.50531300264409
1616198400,58026.91,59928,57827.97,58116.7,9725.29563,20744.49986450002,9725.29563,20744.49986450002,60.6187905816797,2173384.5751799997,4110885.049591617,4110885.049591617,2173384.5751799997,23.900160304064503,50,0,-27.087002129792836,2840.373930660491,2867.460932790284,60.6187905816797,71.48956953462404,73.13129449569264
1616284800,58126.34,58651.22,55543.89,57363.32,11841.653,20083.169267500016,11841.653,20083.169267500016,58.50017862905887,2161542.9221799998,4112910.6451412016,4112910.6451412016,2161542.9221799998,22.874840513128,42.857142857142854,0,-150.03227726493833,2679.920586209111,2829.9528634740495,58.50017862905887,64.48482844468987,70.16409117054589
1616371200,57377.29,58421.68,53739.5,54110.07,19512.17092,20205.598949500018,19512.17092,20205.598949500018,50.32145754975434,2142030.75126,4096487.04628713,4096487.04628713,2142030.75126,21.29515615095682,35.714285714285715,0,-452.6420088637333,2264.150352394383,2716.792361258116,50.32145754975434,22.779440515555972,52.91794616495671
1616457600,54111.49,55858,53000,54345.54,19221.77105,20101.612919500018,19221.77105,20101.612919500018,50.85699853363235,2161252.52231,4095364.408770102,4095364.408770102,2161252.52231,19.965910310630044,28.571428571428573,0,-628.3250161135002,1931.386091116241,2559.711107229741,50.85699853363235,15.310322070444746,34.19153034356362
1616544000,54333.27,57209.97,51673.82,52276.16,23775.22786,20121.024616500017,23775.22786,20121.024616500017,46.14861447628732,2137477.29445,4076762.7295853337,4076762.7295853337,2137477.29445,18.810535097641075,21.428571428571427,100,-860.901280619466,1483.5845064554087,2344.4857870748747,46.14861447628732,5.955136272903744,14.681632952968238
1616630400,52259.69,53238,50305,51325.01,29642.05864,20329.717814000018,29642.05864,20329.717814000018,44.126462840119295,2107835.23581,4067737.9203373464,4067737.9203373464,2107835.23581,17.673179761474326,14.285714285714286,100,-1043.6201100968292,1039.9606494538384,2083.5807595506676,44.126462840119295,8.882435156682028,10.049297833343596
1616716800,51320.76,55125.13,51250,55072.44,17843.02183,20627.976308500016,17843.02183,20627.976308500016,52.885882156459054,2125678.25764,4085095.720344996,4085095.720344996,2125678.25764,16.845400162698215,7.142857142857143,92.85714285714286,-883.2798220335833,979.4809820086884,1862.7608040422717,52.885882156459054,41.515746574417996,18.78443933466801
1616803200,55080.9,56640,53966,55856.53,11333.34784,20496.385242000015,11333.34784,20496.385242000015,54.49341718339202,2137011.60548,4089787.8280711556,4089787.8280711556,2137011.60548,16.54699156046307,0,85.71428571428571,-703.4222906193468,983.4829407680882,1686.905231387435,54.49341718339202,48.80465934065933,33.06761369058654
1616889600,55856.54,56587.08,54701,55778.82,9235.81746,20015.361058000017,9235.81746,20015.361058000017,54.29568816971596,2127775.78802,4091107.818185317,4091107.818185317,2127775.78802,16.26989785838758,0,78.57142857142857,-574.1549791718021,969.2115074226822,1543.3664865944843,54.29568816971596,53.16416846427812,47.82819145978524
1616976000,55781.22,58400,54900,57613.48,17552.38318,19834.122021500014,17552.38318,19834.122021500014,58.15600431223676,2145328.1711999997,4100771.4582688976,4100771.4582688976,2145328.1711999997,16.565703980824328,0,71.42857142857143,-360.021442482006,1093.3396834919768,1453.3611259739828,58.15600431223676,74.61439509954062,58.86107430149278
1617062400,57613.76,59397.48,57000,58786.46,15105.09114,19173.071977500014,15105.09114,19173.071977500014,60.455694586739874,2160433.26234,4108177.204439711,4108177.204439711,2160433.26234,17.124146222938638,14.285714285714286,64.28571428571429,-145.3269438771399,1271.7024461275578,1417.0293900046977,60.455694586739874,86.58968861664113,71.45608406015337
1617148800,58786.46,59800,56873.8,58800,17376.64123,18823.442714500015,17376.64123,18823.442714500015,60.482692878274776,2177809.90357,4113677.2540286747,4113677.2540286747,2177809.90357,17.75737484348947,7.142857142857143,57.142857142857146,-15.197008229292578,1398.033129718082,1413.2301379473745,60.482692878274776,86.72792240939255,82.64400204185819
1617235200,58800.01,59474.94,57930,58726.48,11096.34436,18290.232312000015,11096.34436,18290.232312000015,60.242187616274684,2166713.55921,4114022.151860414,4114022.151860414,2166713.55921,18.345372848286665,0,50,49.58654263256858,1475.213316238085,1425.6267736055165,60.242187616274684,87.51408084796844,86.94389729133412
1617321600,58726.47,60055.02,58441.88,58981.04,10966.94443,17723.514517500014,10966.94443,17723.514517500014,60.82307659739189,2177680.5036400002,4110386.174065522,4110386.174065522,2177680.5036400002,19.07253621055604,100,42.857142857142854,90.84046607881874,1539.1773562040398,1448.336890125221,60.82307659739189,88.98484310801418,87.7422821217918
1617408000,58981.04,59752,56943,57094.34,8405.27851,17464.679347000016,8405.27851,17464.679347000016,54.47076879327502,2169275.22513,4102886.594985713,4102886.594985713,2169275.22513,18.948520322265292,92.85714285714286,35.714285714285715,-21.673378553878592,1421.245166932873,1442.9185454867516,54.47076879327502,69.63411357104907,82.04434584234399
1617494400,57094.34,58500,56478.53,58215.94,6301.44631,16197.181349000017,6301.44631,16197.181349000017,57.32418305666594,2175576.67144,4107417.063899245,4107417.063899245,2175576.67144,18.59673966991798,85.71428571428571,28.571428571428573,-32.635643509318925,1402.123991100103,1434.759634609422,57.32418305666594,81.13767971758011,79.91887879888121
1617580800,58216.73,59251.76,56817.64,59123.02,9204.87745,15435.805562000018,9204.87745,15435.805562000018,59.53303891668055,2184781.54889,4115648.2540019383,4115648.2540019383,2184781.54889,18.558122653028185,78.57142857142857,21.428571428571427,7.0115323300701675,1443.5240500220098,1436.5125176919396,59.53303891668055,90.44104524913794,80.40427951258914
1617667200,59134.07,59475,57333.33,58019.98,10354.34449,14819.143351500015,10354.34449,14819.143351500015,55.753913998441675,2174427.2044,4111933.411063586,4111933.411063586,2174427.2044,18.608760082522355,71.42857142857143,14.285714285714286,-51.99578837312902,1371.5177822255282,1423.5135705986572,55.753913998441675,79.12783768648686,83.56885421773507
1617753600,58021.67,58630,55400,55955.75,17787.3087,14635.533421000015,17787.3087,14635.533421000015,49.430137383392065,2156639.8957,4100267.029180939,4100267.029180939,2156639.8957,17.623866150024178,64.28571428571429,7.142857142857143,-230.96696636330717,1134.8048626445234,1365.7718290078305,49.430137383392065,57.95629137171002,75.84172476911169
1617840000,55962.67,58152,55700,58083.1,8073.61182,14217.731792500015,8073.61182,14217.731792500015,55.084260481770805,2164713.5075200005,4107886.911919048,4107886.911919048,2164713.5075200005,16.709321784133017,57.142857142857146,0,-207.723937387756,1106.1169072731354,1313.8408446608914,55.084260481770805,77.60459374311473,71.5629076004373
1617926400,58083.1,58869.69,57670.51,58092.68,8094.76087,14136.205054500015,8094.76087,14136.205054500015,55.108602011108204,2172808.2683900003,4105491.6543704644,4105491.6543704644,2172808.2683900003,16.19707147587397,50,0,-193.63308804404483,1071.7994846058355,1265.4325726498803,55.108602011108204,67.77248227136718,67.77778912873073
1618012800,58092.68,61218.97,57875.41,59778.6,12817.82546,14185.013677500017,12817.82546,14185.013677500017,59.289869378809755,2185626.0938500003,4107265.91473349,4107265.91473349,2185626.0938500003,16.682489622129886,100,0,-78.59588165331616,1167.1877205832352,1245.7836022365514,59.289869378809755,77.90155523882433,74.42621041776884
1618099200,59778.59,60658.89,59177.06,59985.26,7278.97953,13573.354108000018,7278.97953,13573.354108000018,59.78434411858744,2192905.0733800004,4107926.9435123326,4107926.9435123326,2192905.0733800004,17.133235043653233,92.85714285714286,0,-0.5416762367178762,1245.106506940654,1245.648183177372,59.78434411858744,80.47609024888553,75.38337591969243
1618185600,59983.66,61199,59369,59839.82,11467.742,13185.652655500016,11467.742,13185.652655500016,59.23901141722695,2181437.3313800003,4102360.0127565293,4102360.0127565293,2181437.3313800003,17.761605283925434,85.71428571428571,0,27.771605382195276,1280.362689905116,1252.5910845229207,59.23901141722695,76.29907011034598,78.2255718660187
1618272000,59836.88,63774.39,59799.01,63588.22,17897.78025,12891.780275000017,17897.78025,12891.780275000017,67.47382562152809,2199335.11163,4118581.460304175,4118581.460304175,2199335.11163,19.211685907942012,100,57.142857142857146,271.8564855720981,1592.4116914880433,1320.5552059159452,67.47382562152809,97.77691270647775,84.85069102190316
1618358400,63588.22,64899,61277.91,62971.8,22570.85556,12538.220121000017,22570.85556,12538.220121000017,65.14309045001767,2176764.25607,4117127.2003132044,4117127.2003132044,2176764.25607,20.874595201521707,100,50,359.2152594989343,1769.574280289613,1410.3590207906786,65.14309045001767,79.7115485840615,84.59584380029516
1618444800,62971.8,63831.82,62036.73,63229.04,11209.46486,12206.542272500017,11209.46486,12206.542272500017,65.67593771379063,2187973.7209300003,4120808.5287251035,4120808.5287251035,2187973.7209300003,22.418725259845708,92.85714285714286,42.857142857142854,398.69787095931497,1908.7313594898224,1510.0334885305074,65.67593771379063,82.41962311822299,86.63602813625415
1618531200,63229.04,63604.34,60048.43,61427.27,19867.42753,12633.246257000017,19867.42753,12633.246257000017,58.8859206755512,2168106.2934000003,4116348.692374557,4116348.692374557,2168106.2934000003,22.55088023654259,85.71428571428571,35.714285714285715,273.7929664930373,1852.274696646804,1578.4817301537666,58.8859206755512,63.45162648699859,75.19426606309445
1618617600,61427.27,62572.48,59700,60058.86,10847.78228,12713.844498000017,10847.78228,12713.844498000017,54.294744612047566,2157258.5111200004,4108211.345083835,4108211.345083835,2157258.5111200004,22.464408050150134,78.57142857142857,28.571428571428573,79.4328664857801,1677.7728132609918,1598.3399467752117,54.294744612047566,49.04579429413623,64.97234796645267
1618704000,60067.2,60437.97,51300,56274.41,36891.72388,13680.811533000018,36891.72388,13680.811533000018,44.062845802572525,2120366.7872400004,4111484.9008416343,4111484.9008416343,2120366.7872400004,22.625535566810665,71.42857142857143,100,-302.6387989689613,1220.0414480640102,1522.6802470329715,44.062845802572525,36.57923376718879,49.69221818277461
1618790400,56273.65,57600,54187.85,55696.83,16838.4062,13767.477286000018,16838.4062,13767.477286000018,42.73906074833469,2103528.3810400004,4109539.637198483,4109539.637198483,2103528.3810400004,22.775153975138302,64.28571428571429,92.85714285714286,-576.9908824148881,801.4416440143614,1378.4325264292495,42.73906074833469,32.33200970659609,39.31901258930711
1618876800,55696.83,57111,53430.01,56499.29,18608.29421,13829.059935000018,18608.29421,13829.059935000018,45.202281519787434,2122136.6752500003,4121963.2475863597,4121963.2475863597,2122136.6752500003,23.11949730553266,57.142857142857146,85.71428571428571,-680.0584214640144,528.3594995992316,1208.417921063246,45.202281519787434,38.23288477093905,35.71470941490805
1618963200,56477.67,56810.56,53620.91,53800.86,15581.05091,14053.295262500018,15581.05091,14053.295262500018,39.109694503036046,2106555.62434,4108140.2642456884,4108140.2642456884,2106555.62434,23.439244683756,50,78.57142857142857,-892.2337860887197,93.12568845234637,985.3594745410661,39.109694503036046,18.390028678579313,29.65164105203822
1619049600,53795.62,55469.98,50400,51701.59,30427.90599,15026.34334050002,30427.90599,15026.34334050002,35.141413339893234,2076127.7183500002,4093335.559198305,4093335.559198305,2076127.7183500002,24.555664513827505,42.857142857142854,100,-1121.4026660657428,-416.39385804111225,705.0088080246305,35.141413339893234,8.977101869094396,21.866671772870987
1619136000,51695.98,52130.58,47464.65,51187.27,38794.87277,16545.823053500022,38794.87277,16545.823053500022,34.225164674614604,2037332.8455800002,4116444.130873917,4116444.130873917,2037332.8455800002,26.17809807006909,35.714285714285715,100,-1245.505631094271,-851.8732308432081,393.6324002510628,34.225164674614604,21.352215597369536,16.239782048347816
1619222400,51187.75,51260.61,48726.87,50089.15,11839.15787,16822.70863150002,11839.15787,16822.70863150002,32.28938899259231,2025493.6877100002,4117335.7567332215,4117335.7567332215,2025493.6877100002,27.684643515150565,28.571428571428573,92.85714285714286,-1331.6676264644861,-1270.952132829545,60.7154936349412,32.28938899259231,15.053615420133244,15.127644295532457
1619308800,50101.42,50591.38,47044.01,49121,14633.52652,17094.141085000017,14633.52652,17094.141085000017,30.643770294449567,2010860.1611900001,4119838.1299061067,4119838.1299061067,2010860.1611900001,29.39294675156655,21.428571428571427,100,-1378.2026812625827,-1662.0378579432872,-283.8351766807045,30.643770294449567,11.63254641979636,16.012792479099783
1619395200,49121,54400,48817.62,54053.6,18005.2383,17476.68577550002,18005.2383,17476.68577550002,45.79987526480572,2028865.3994900002,4135608.832202782,4135608.832202782,2028865.3994900002,29.173007612936768,14.285714285714286,92.85714285714286,-1017.7476104790272,-1556.0196897794885,-538.2720793004613,45.79987526480572,39.25843699716436,21.981532945698053
1619481600,54047.8,55509.39,53321,55069.62,13957.10095,17285.17538800002,13957.10095,17285.17538800002,48.305728269356344,2042822.5004400003,4143956.408082039,4143956.408082039,2042822.5004400003,28.520165463431933,7.142857142857143,85.71428571428571,-668.7219972056407,-1374.1745758075122,-705.4525786018714,48.305728269356344,44.94883503155141,31.94660614950411
1619568000,55069.61,56476.17,53887,54894.03,16484.35125,17705.712359500023,16484.35125,17705.712359500023,47.89361638209844,2026338.1491900003,4140294.8813196453,4140294.8813196453,2026338.1491900003,27.531708430075668,0,78.57142857142857,-419.6782595410999,-1230.0504030282464,-810.3721434871464,47.89361638209844,46.76023853021923,43.6558368529784
1619654400,54889.81,55226.86,52369.61,53580,14592.33123,18030.59087750002,14592.33123,18030.59087750002,44.81251485116643,2011745.8179600004,4138065.774726957,4138065.774726957,2011745.8179600004,27.040912043748726,0,71.42857142857143,-318.0525583419144,-1207.9378414145394,-889.885283072625,44.81251485116643,39.46775215228199,43.72560857135094
1619740800,53580,58075.01,53068.43,57798.77,16536.34704,18216.51695650002,16536.34704,18216.51695650002,54.85428291268583,2028282.1650000003,4152777.322999603,4152777.322999603,2028282.1650000003,25.515808511678824,0,64.28571428571429,39.662262863625415,-840.3074544930932,-879.9697173567187,54.85428291268583,69.25833646199526,51.828775714832226
1619827200,57798.77,58550,57050.94,57859.28,10787.06382,18391.92117100002,10787.06382,18391.92117100002,54.98081282841044,2039069.2288200003,4153623.7030287604,4153623.7030287604,2039069.2288200003,23.935080056820247,0,57.142857142857146,273.6759441287842,-537.8747871957385,-811.5507313245226,54.98081282841044,80.7473667235082,63.15781844592855
1619913600,57859.28,57972.26,56072,56625.2,7647.63999,18200.916070500018,7647.63999,18200.916070500018,51.79261441255362,2031421.5888300003,4150428.7952358997,4150428.7952358997,2031421.5888300003,22.785734568129627,0,50,334.6472912701058,-393.2416172368903,-727.8889085069961,51.79261441255362,83.27132215480803,77.75900844677057
1620000000,56625.21,58986,56500,57212.73,15165.02105,18064.278110500018,15165.02105,18064.278110500018,53.18447426148973,2046586.6098800004,4143959.3216138696,4143959.3216138696,2046586.6098800004,21.341443761864934,100,42.857142857142854,399.45100272007926,-228.575155106897,-628.0261578269763,53.18447426148973,85.15096730109474,83.05655205980374
1620086400,57212.73,57247.24,53057.7,53241.92,23492.07295,18110.33898000002,23492.07295,18110.33898000002,43.94890394153536,2023094.5369300004,4122533.20801924,4122533.20801924,2023094.5369300004,21.0568934664143,92.85714285714286,35.714285714285715,171.44660891378714,-413.7178966847423,-585.1645055985294,43.94890394153536,51.90014394585825,73.44081113392042
1620172800,53241.91,57980.86,52913.02,57515.69,22918.91903,18695.811688500016,22918.91903,18695.811688500016,53.3404324443746,2046013.4559600004,4141244.7355115493,4141244.7355115493,2046013.4559600004,20.510418694754012,85.71428571428571,28.571428571428573,297.62720770728873,-213.13049596441851,-510.75770367170725,53.3404324443746,87.68789791316189,74.9130030533717
1620259200,57515.69,58400,55288,56440.66,18244.15032,18614.64782800002,18244.15032,18614.64782800002,51.02450426801819,2027769.3056400004,4136515.5609678035,4136515.5609678035,2027769.3056400004,19.838568756345115,78.57142857142857,21.428571428571427,297.1632298283822,-139.30366638622945,-436.46689621461167,51.02450426801819,78.68579692329338,72.75794626077125
1620345600,56444.82,58735.95,55300,57380.39,18323.91005,18988.45421650002,18323.91005,18988.45421650002,52.94767071289714,2046093.2156900004,4140381.0769740148,4140381.0769740148,2046093.2156900004,19.078068020477186,71.42857142857143,14.285714285714286,345.24518853404015,-4.910410547061474,-350.1555990811016,52.94767071289714,86.55492091351609,84.30953858332386
1620432000,57380.39,59559.84,56980.01,58958.05,15374.95892,17912.61596850002,15374.95892,17912.61596850002,56.06674970326578,2061468.1746100003,4148583.085328693,4148583.085328693,2061468.1746100003,18.032652801876,100,7.142857142857143,461.15858273141095,226.29262933316204,-234.8659533982489,56.06674970326578,95.19176914355664,86.81082899345544
1620518400,58958.06,59300.52,56265.3,58312.57,17169.73753,17929.182535000018,17169.73753,17929.182535000018,54.475634583040296,2044298.4370800003,4154575.4833625355,4154575.4833625355,2044298.4370800003,17.328427854823023,92.85714285714286,0,470.58436008765045,353.36449671131413,-117.2198633763363,54.475634583040296,88.38908531011283,90.04525845572859
1620604800,58313.84,59592.2,53600,55866.41,24646.87074,18231.111361500014,24646.87074,18231.111361500014,48.8211738384184,2019651.5663400004,4148572.8215320655,4148572.8215320655,2019651.5663400004,17.563634279920457,100,0,296.78389956219166,253.76001107640332,-43.023888485788376,48.8211738384184,48.41476534041119,77.33187326469364
1620691200,55866.38,56962.07,54511.48,56753.19,15446.6505,18224.391341000017,15446.6505,18224.391341000017,50.814338262628596,2035098.2168400004,4161386.231582672,4161386.231582672,2035098.2168400004,17.78204024608236,92.85714285714286,14.285714285714286,229.27570405110475,243.57074157809257,14.295037526987812,50.814338262628596,60.69263242133368,65.83216102395265
1620777600,56753.19,58041,48500,49498.77,29660.85698,18186.038890500015,29660.85698,18186.038890500015,37.83354279692288,2005437.3598600004,4137935.2842821423,4137935.2842821423,2005437.3598600004,19.469061021730617,85.71428571428571,100,-288.14659819124597,-345.8882102120697,-57.741612020823695,37.83354279692288,9.004255242422577,39.37055100138923
1620864000,49498.76,52500,46000,49690.11,42250.10181,18358.800342500013,42250.10181,18358.800342500013,38.281378800118304,2047687.4616700003,4143656.728069096,4143656.728069096,2047687.4616700003,21.474804429620388,78.57142857142857,100,-584.6144612343617,-788.5096885637759,-203.89522732941413,38.281378800118304,27.148732361207173,32.28187334165455
1620950400,49682.28,51569.56,48895,49893.48,21987.80811,18866.232854500013,21987.80811,18866.232854500013,38.786131344450745,2069675.2697800004,4138086.1150429025,4138086.1150429025,2069675.2697800004,23.337280451232317,71.42857142857143,92.85714285714286,-724.9508460073487,-1110.0837848386,-385.1329388312513,38.786131344450745,28.64495813775551,21.599315247128498
1621036800,49893.48,50730.58,46573,46775.51,21936.12903,19231.362980000013,21936.12903,19231.362980000013,34.171883242271164,2047739.1407500005,4118286.943324543,4118286.943324543,2047739.1407500005,25.44719551641454,64.28571428571429,85.71428571428571,-970.3782297089465,-1598.1057259674344,-627.7274962584879,34.171883242271164,5.705551713482749,20.499747404148554
1621123200,46771.01,49808.28,43825,46450.79,30655.34495,19863.868312500013,30655.34495,19863.868312500013,33.721938889961564,2017083.7958000004,4114538.077167533,4114538.077167533,2017083.7958000004,27.792142175164702,57.142857142857146,100,-1088.3385288533325,-1988.1506573251536,-899.8121284718211,33.721938889961564,16.653495864833335,17.001335238690608
1621209600,46450.78,46646.15,42101,43580.5,43660.23646,21349.025088000013,43660.23646,21349.025088000013,29.965987921070223,1973423.5593400004,4099301.685835887,4099301.685835887,1973423.5593400004,30.183759479736878,50,100,-1280.1930418725772,-2500.0534308125425,-1219.8603889399653,29.965987921070223,8.45853915111599,10.272528909810768
1621296000,43571.89,45851,42300,42857.15,28210.31464,21935.32325750001,28210.31464,21935.32325750001,29.086743012178502,1945213.2447000004,4079943.7377414666,4079943.7377414666,1945213.2447000004,32.40454697683961,42.857142857142854,92.85714285714286,-1368.3751719271954,-2930.3293538489597,-1561.9541819217643,29.086743012178502,4.323031009879263,9.811688675276274
1621382400,42865.05,43591.7,30000,36731.75,109537.25647,26682.569519500008,109537.25647,26682.569519500008,22.946691765529707,1835675.9882300005,4078910.557471195,4078910.557471195,1835675.9882300005,35.49815171451804,35.714285714285715,100,-1728.582214851426,-3722.681950486047,-1994.0997356346209,22.946691765529707,22.748393157656412,11.843321106217298
1621468800,36735.44,42605,35000,40623.33,51445.78759,28428.041547000008,51445.78759,28428.041547000008,32.670932339832675,1887121.7758200006,4103545.4117558757,4103545.4117558757,1887121.7758200006,38.370784685219434,28.571428571428573,92.85714285714286,-1597.206504127877,-3990.607865794467,-2393.40136166659,32.670932339832675,35.899088273261206,20.99017081359904
1621555200,40623.24,42275.99,33501.54,37340.77,55961.91449,30686.784080500005,55961.91449,30686.784080500005,29.310750798612517,1831159.8613300005,4096555.3783450187,4096555.3783450187,1831159.8613300005,41.12504581382018,21.428571428571427,85.71428571428571,-1618.799676798907,-4416.900957665224,-2798.101280866317,29.310750798612517,24.80643547961962,27.81797230351249
1621641600,37333.09,38889.76,35257.52,37476.83,29239.04179,31766.354170500003,29239.04179,31766.354170500003,29.63379934623032,1860398.9031200004,4103046.6285153325,4103046.6285153325,1860398.9031200004,43.68257400466373,14.285714285714286,78.57142857142857,-1513.280918496222,-4689.702428986595,-3176.421510490373,29.63379934623032,25.266218800900248,28.657247517927104
1621728000,37476.84,38319.36,31111,34758.67,53433.31724,33679.76898000001,53433.31724,33679.76898000001,26.981015027749223,1806965.5858800004,4103691.384039964,4103691.384039964,1806965.5858800004,46.285466501368994,7.142857142857143,71.42857142857143,-1512.322911201375,-5066.825149492091,-3554.5022382907164,26.981015027749223,16.0808253526267,22.0511598777156
1621814400,34758.88,39966.87,34407.17,38878.56,44419.47253,34726.13895900001,44419.47253,34726.13895900001,36.29028368461992,1851385.0584100003,4130720.653447808,4130720.653447808,1851385.0584100003,47.98316323949391,0,64.28571428571429,-1137.116511390826,-4975.897877529249,-3838.781366138423,36.29028368461992,31.662779501444305,24.336607884990496
1621900800,38874.53,39878.51,36481.26,38361.81,26107.57143,34885.57157900001,26107.57143,34885.57157900001,35.67590753209193,1825277.4869800003,4133516.8091221936,4133516.8091221936,1825277.4869800003,49.55959592489562,7.142857142857143,57.142857142857146,-840.315223243947,-4889.175395193357,-4048.86017194941,35.67590753209193,29.81994222745265,25.854515693841297
1621987200,38361.81,40900,37837.36,39293.23,25107.70082,35228.74910400001,25107.70082,35228.74910400001,37.722470539530796,1850385.1878000002,4132279.72214699,4132279.72214699,1850385.1878000002,50.553998403712065,0,50,-513.8814795110675,-4691.212021338244,-4177.330541827177,37.722470539530796,41.30324444444446,34.261988724447214
1622073600,39293.23,40440.95,37191.99,38556.88,19390.90886,35282.09904450001,19390.90886,35282.09904450001,36.72759811103249,1830994.27894,4129181.0776386135,4129181.0776386135,1830994.27894,51.5442045735823,0,42.857142857142854,-291.24882829145736,-4541.391577191498,-4250.142748900041,36.72759811103249,39.671092038966016,36.93142623695446
1622160000,38556.88,38900,34688,35680.47,36231.74854,36324.93852550001,36231.74854,36324.93852550001,33.05969928200409,1794762.5304,4110023.8416691236,4110023.8416691236,1794762.5304,52.70946616598125,0,35.714285714285715,-281.25727699414165,-4601.714345142718,-4320.457068148577,33.05969928200409,27.401404109291686,36.125246864234136
1622246400,35680.48,37325,33650.86,34627.82,27999.16509,36866.40990350001,27999.16509,36866.40990350001,31.80778072324526,1766763.36531,4096914.7266732007,4096914.7266732007,1766763.36531,53.886431489882256,0,28.571428571428573,-288.0396764238376,-4680.506663678374,-4392.466987254536,31.80778072324526,23.363058276639872,30.145184808299273
1622332800,34627.81,36500,33333,35669.44,16038.96112,36436.014422500004,16038.96112,36436.014422500004,34.45287306363255,1782802.3264300001,4104541.108350304,4104541.108350304,1782802.3264300001,55.008961822120675,0,21.428571428571427,-170.6721991278855,-4605.8072361643935,-4435.135037036508,34.45287306363255,34.05856609486279,28.27434282693153
1622419200,35669.44,37534.09,34183,37279.31,19527.13039,36640.038417,19527.13039,36640.038417,38.428038289223544,1802329.4568200002,4121098.9825993087,4121098.9825993087,1802329.4568200002,55.50558513085747,0,14.285714285714286,55.010802546129526,-4366.371533853846,-4421.382336399975,38.428038289223544,45.92334868462556,34.448324352042825
1622505600,37276.23,37918.97,35669.14,36685,15713.11732,35942.651434,15713.11732,35942.651434,37.52332747497371,1786616.3395000002,4119575.6728298306,4119575.6728298306,1786616.3395000002,55.76155462865871,0,7.142857142857143,195.9622016285075,-4176.429584364341,-4372.391785992849,37.52332747497371,49.18442873224101,43.05544783724321
1622592000,36684.99,38237.37,35920,37577.91,13952.37317,34527.765002,13952.37317,34527.765002,39.81589789574539,1800568.7126700003,4125587.119854512,4125587.119854512,1800568.7126700003,55.82247871837712,0,0,370.88083696564536,-3908.7907397857925,-4279.671576751438,39.81589789574539,56.2633547938055,50.45704407022411
1622678400,37581.83,39489.82,37184.88,39248.55,14325.77051,34144.663122,14325.77051,34144.663122,43.959398918754836,1814894.4831800002,4136913.7852676786,4136913.7852676786,1814894.4831800002,55.187478414591006,0,21.428571428571427,606.7075532608242,-3521.2871351754075,-4127.994688436232,43.959398918754836,72.88452564668668,59.44410305757781
1622764800,39248.54,39291.24,35593.22,36856.52,17917.6468,33943.7390105,17917.6468,33943.7390105,39.74060273513963,1796976.8363800002,4131238.020989915,4131238.020989915,1796976.8363800002,54.8935253378403,0,14.285714285714286,607.6949310612131,-3368.3760246097154,-3976.0709556709285,39.74060273513963,58.693635713556,62.61383871801613
1622851200,36856.53,37921.35,34832.17,35539.49,13654.70461,33093.706993499996,13654.70461,33093.706993499996,37.60092178688368,1783322.1317700003,4123836.2674314855,4123836.2674314855,1783322.1317700003,54.75552985409826,28.571428571428573,7.142857142857143,528.6567300432844,-3315.250043116823,-3843.906773160107,37.60092178688368,45.23945244662374,58.939204602288875
1622937600,35539.97,36477.86,35258,35800.48,8184.51756,31319.921048499993,8184.51756,31319.921048499993,38.309754821738366,1791506.6493300004,4122931.170601649,4122931.170601649,1791506.6493300004,54.627391190623506,21.428571428571427,0,503.1039939104385,-3215.0267807720593,-3718.1307746824978,38.309754821738366,32.608431346636756,45.51383983560557
1623024000,35800.48,36812.39,33333,33575.91,18997.73034,30859.291833499992,18997.73034,30859.291833499992,34.69228005045126,1772508.9189900004,4106586.0538961594,4106586.0538961594,1772508.9189900004,54.85029467436176,14.285714285714286,42.857142857142854,352.6451193856724,-3277.3243754504074,-3629.96949483608,34.69228005045126,3.2101229020748447,27.01933556511186
1623110400,33567.26,34069,31004.95,33402.13,34937.572,27129.307609999996,34937.572,27129.307609999996,34.41885958698046,1737571.3469900005,4126315.767904521,4126315.767904521,1737571.3469900005,55.41044109416347,7.142857142857143,100,261.8576771957237,-3302.6473983414253,-3564.505075537149,34.41885958698046,24.226052420149436,20.014868889620427
1623196800,33402.13,37573.99,32408.53,37403.86,26040.9123,25859.063845499993,26040.9123,25859.063845499993,45.140943034496914,1763612.2592900004,4150641.3091012314,4150641.3091012314,1763612.2592900004,54.07735291869763,0,92.85714285714286,479.1048273368333,-2965.624041366107,-3444.7288687029404,45.140943034496914,67.8137982195846,31.749991180603043
1623283200,37404.75,38425.67,35800,36694.05,19853.82857,24053.659549499997,19853.82857,24053.659549499997,43.773862493635434,1743758.4307200005,4144308.079413047,4144308.079413047,1743758.4307200005,52.44819611248026,0,85.71428571428571,576.2621851371055,-2724.4011372815585,-3300.663322418664,43.773862493635434,67.04993712337375,53.02992925436934
1623369600,36694.91,37695,35944,37338.44,14142.2078,23298.817849999996,14142.2078,23298.817849999996,45.39075449353132,1757900.6385200005,4152690.6691511762,4152690.6691511762,1757900.6385200005,50.935407649564134,42.857142857142854,78.57142857142857,678.1649006393195,-2452.9571966195144,-3131.122097258834,45.39075449353132,74.64451429426735,69.83608321240865
1623456000,37340.08,37448,34635.47,35557.33,14516.55989,21352.979982499994,14516.55989,21352.979982499994,41.81170827575956,1743384.0786300006,4147690.2643956603,4147690.2643956603,1743384.0786300006,49.85776277928261,35.714285714285715,71.42857142857143,621.3645871064155,-2354.4163633758144,-2975.78095048223,41.81170827575956,53.652913951539645,65.11578845639367
1623542400,35557.32,39396,34780.57,39015.24,15748.97663,19919.455187499992,15748.97663,19919.455187499992,50.046839156745506,1759133.0552600005,4160840.7484294605,4160840.7484294605,1759133.0552600005,47.920649045788004,28.571428571428573,64.28571428571429,800.9956573672307,-1974.5363787731912,-2775.532036140422,50.046839156745506,94.40674989716989,74.23472604765904
1623628800,39015.24,41076.03,38744.83,40539.47,21916.85846,19709.91953899999,21916.85846,19709.91953899999,53.191549616103046,1781049.9137200005,4172668.631618958,4172668.631618958,1781049.9137200005,45.40072787132674,100,57.142857142857146,994.1722097247016,-1532.8167739845449,-2526.9889837092464,53.191549616103046,94.67226950833478,80.9106444523482
1623715200,40537.93,41322.55,39510.98,40162.37,17020.71757,19305.570376499993,17020.71757,19305.570376499993,52.314090120738655,1764029.1961500004,4167888.263820617,4167888.263820617,1764029.1961500004,42.95755586959079,100,50,1062.1078154443048,-1199.3542144038656,-2261.4620298481705,52.314090120738655,88.75533069706134,92.61145003418875
1623801600,40158.06,40499,38105,38351,17238.59003,19197.954434999992,17238.59003,19197.954434999992,48.20093385518353,1746790.6061200004,4154192.4416664564,4154192.4416664564,1746790.6061200004,41.15230681281483,92.85714285714286,42.857142857142854,954.0310061840537,-1068.9232721181033,-2022.954278302157,48.20093385518353,71.19921299527019,84.87560440022217
1623888000,38351,39554.98,37365.63,38095.17,15970.3631,18184.88516299999,15970.3631,18184.88516299999,47.63132312421816,1730820.2430200004,4148865.437276552,4148865.437276552,1730820.2430200004,39.709607682728986,85.71428571428571,35.714285714285715,838.3950892026392,-974.9604167988582,-1813.3555060014974,47.63132312421816,68.71966348763274,76.22473572665483
1623974400,38103.94,38216.22,35153.16,35841.81,23472.39153,17958.54648499999,23472.39153,17958.54648499999,42.830262008096675,1707347.8514900005,4135947.3688268275,4135947.3688268275,1707347.8514900005,39.010800308706344,78.57142857142857,28.571428571428573,594.6945257894336,-1069.9873487647055,-1664.681874554139,42.830262008096675,46.87970070559041,62.26619239616451
1624060800,35840.96,36457.18,34833.26,35484.79,16801.10116,17996.653486999996,16801.10116,17996.653486999996,42.106099150899894,1690546.7503300004,4132627.74635885,4132627.74635885,1690546.7503300004,38.44883218132137,71.42857142857143,21.428571428571427,403.16526873285807,-1160.7252886380666,-1563.8905573709246,42.106099150899894,43.41939986043265,53.006254684552005
1624147200,35484.8,36139.73,33347.05,35585.78,19400.08896,17990.301415499995,19400.08896,17990.301415499995,42.40275827530126,1709946.8392900005,4144331.5154544963,4144331.5154544963,1709946.8392900005,38.32019128579508,64.28571428571429,14.285714285714286,282.6864889221945,-1210.5324462181816,-1493.218935140376,42.40275827530126,44.398212762657955,44.89910444289374
1624233600,35585.79,35741.54,31259,31609.82,41304.4127,19269.866184499995,41304.4127,19269.866184499995,34.83468822626857,1668642.4265900005,4109492.3720274596,4109492.3720274596,1668642.4265900005,38.68902082593012,57.142857142857146,7.142857142857143,-47.76925569907462,-1552.9305047642192,-1505.1612490651446,34.83468822626857,5.8625067845235215,31.22670646920478
1624320000,31609.82,33352,28800,32538.37,48388.26727,20991.660889499995,48388.26727,20991.660889499995,37.63421977570742,1717030.6938600005,4140582.6841573496,4140582.6841573496,1717030.6938600005,39.51744460453917,50,100,-179.40821158171866,-1729.4215135422928,-1550.0133019605742,37.63421977570742,29.85310499858254,26.70460818192141
1624406400,32538.9,34881.02,31708.03,33688.35,23124.82691,21431.613709499994,23124.82691,21431.613709499994,41.01399301575672,1740155.5207700005,4146323.0961711477,4146323.0961711477,1740155.5207700005,39.485936716341634,42.857142857142854,92.85714285714286,-164.99187150993703,-1756.2531413479956,-1591.2612698380585,41.01399301575672,39.036378373414344,24.917330052173543
1624492800,33688.51,35295.67,32300,34654.58,16868.95529,21379.179133999998,16868.95529,21379.179133999998,43.771233660609234,1757024.4760600005,4155971.9514188427,4155971.9514188427,1757024.4760600005,39.24487882770045,35.714285714285715,85.71428571428571,-71.13707574054388,-1680.1826145137384,-1609.0455387731945,43.771233660609234,46.75229885286943,38.547260741622175
1624579200,34654.87,35500,31300,31594.63,26505.20707,22021.704256999998,26505.20707,22021.704256999998,37.75268215399951,1730519.2689900005,4133185.4249007637,4133185.4249007637,1730519.2689900005,39.260478852048166,28.571428571428573,78.57142857142857,-189.19108432468352,-1845.5343941790488,-1656.3433098543653,37.75268215399951,22.316780527927623,36.035152584737205
1624665600,31594.62,32711.68,30173.49,32275.19,18299.40151,22527.448454499994,18299.40151,22527.448454499994,39.737351590026236,1748818.6705000005,4145190.966798126,4145190.966798126,1748818.6705000005,39.53373179802514,21.428571428571427,71.42857142857143,-194.7350254796761,-1899.7620917039603,-1705.0270662242842,39.737351590026236,27.751456372703625,32.27351191783363
1624752000,32267.59,34749,32002.21,34709.23,14428.94413,22299.009143999996,14428.94413,22299.009143999996,46.32844803637515,1763247.6146300004,4159202.0856789807,4159202.0856789807,1763247.6146300004,38.72058392508848,14.285714285714286,64.28571428571429,-17.122375831112322,-1726.4300360131747,-1709.3076601820624,46.32844803637515,47.18871156433795,32.41898282165647
1624838400,34708.53,35301.43,33864.99,34493.22,14920.27924,21298.144505999997,14920.27924,21298.144505999997,45.84918722005475,1748327.3353900004,4157332.6363057974,4157332.6363057974,1748327.3353900004,37.69474898555244,7.142857142857143,57.142857142857146,96.89755337275938,-1588.185718466113,-1685.0832718388724,45.84918722005475,45.46374340689396,40.13463711464525
1624924800,34493.22,36675,34233.35,35904.28,17917.61278,20891.979529999997,17917.61278,20891.979529999997,49.52266089319076,1766244.9481700005,4163938.666736319,4163938.666736319,1766244.9481700005,36.090242035345945,0,50,268.69664144306626,-1349.2124700350396,-1617.9091114781058,49.52266089319076,60.725532096760396,51.12599568933084
1625011200,35906.17,36094.42,34033,35060,16700.73762,20734.324982499995,16700.73762,20734.324982499995,47.44860203136178,1749544.2105500004,4163878.5530898324,4163878.5530898324,1749544.2105500004,34.669352943903206,0,42.857142857142854,323.16165092923484,-1213.9570478165624,-1537.1186987457972,47.44860203136178,58.2055940596821,54.79828985444556
1625097600,35060,35066.54,32703.48,33516.11,13210.9654,20687.762862499996,13210.9654,20687.762862499996,43.83336748408416,1736333.2451500003,4159753.7952452917,4159753.7952452917,1736333.2451500003,33.800791720227444,0,35.714285714285715,255.84476074646113,-1217.3127478127208,-1473.157508559182,43.83336748408416,50.08495978216312,56.338695312868616
1625184000,33510.93,33972.06,32704.73,33805.02,11765.66827,20550.218281499998,11765.66827,20550.218281499998,44.68275236004003,1748098.9134200003,4168417.923698794,4168417.923698794,1748098.9134200003,32.99427058395709,0,28.571428571428573,232.1080900611173,-1183.0223959827854,-1415.1304860439027,44.68275236004003,63.55580952380948,57.28212112188496
1625270400,33805.01,34953.07,33320,34682.16,6197.81551,20072.660225499996,6197.81551,20072.660225499996,47.28901566429692,1754296.7289300004,4172559.4278445365,4172559.4278445365,1754296.7289300004,31.715506337784543,71.42857142857143,21.428571428571427,273.9414152674999,-1072.7037169595278,-1346.6451322270277,47.28901566429692,74.69409523809529,62.77828818135603
1625356800,34685.03,35951,34390.53,35284.05,6224.04488,19288.019546499996,6224.04488,19288.019546499996,49.06250351190129,1760520.7738100004,4173463.1183021944,4173463.1183021944,1760520.7738100004,30.016698579935703,64.28571428571429,14.285714285714286,336.48959169942964,-926.0331426027406,-1262.5227343021702,49.06250351190129,82.3371428571429,73.52901587301595
1625443200,35284.06,35290.82,33156.86,33697.78,9607.62048,18917.364691999996,9607.62048,18917.364691999996,44.78577348298285,1750913.1533300004,4168726.211490718,4168726.211490718,1750913.1533300004,28.94220195542762,57.142857142857146,7.142857142857143,268.33236969806717,-927.1072721795863,-1195.4396418776535,44.78577348298285,62.19403174603173,73.07508994709004
1625529600,33697.78,35100,33300,34225.73,10313.02804,18571.086592499996,10313.02804,18571.086592499996,46.458604917014235,1761226.1813700004,4169021.049503462,4169021.049503462,1761226.1813700004,27.944455089812976,50,0,256.1374477928398,-875.2678321366038,-1131.4052799294436,46.458604917014235,62.32767464788953,68.95294975035479
1625616000,34225.72,35077.46,33770.01,33878.56,9404.91239,18242.814056999996,9404.91239,18242.814056999996,45.48275719933198,1751821.2689800004,4161177.807907656,4161177.807907656,1751821.2689800004,27.017975857456523,42.857142857142854,21.428571428571427,223.22598636046723,-852.3727969788597,-1075.598783339327,45.48275719933198,56.98783820989273,60.50318153460474
1625702400,33879.5,33934.62,32111,32875.95,14147.36687,17776.562823999997,14147.36687,17776.562823999997,42.693719379841134,1737673.9021100004,4158899.1727769505,4158899.1727769505,1737673.9021100004,26.8490327814513,35.714285714285715,14.285714285714286,136.7176457408964,-904.7017261632063,-1041.4193719041027,42.693719379841134,41.56665143943478,53.62738809907242
1625788800,32875.95,34100,32255.24,33824.26,8320.92082,17352.553806999997,8320.92082,17352.553806999997,46.06270942547646,1745994.8229300003,4164732.603943113,4164732.603943113,1745994.8229300003,26.58466015363915,28.571428571428573,7.142857142857143,145.3422792797992,-859.7415228043537,-1005.0838020841529,46.06270942547646,56.15264761570776,51.569045755011835
1625875200,33824.25,34267.14,33027.83,33515.35,4906.26016,16627.862366999994,4906.26016,16627.862366999994,45.13192798978323,1741088.5627700002,4163686.394865091,4163686.394865091,1741088.5627700002,26.22508503998372,21.428571428571427,0,132.57819268856986,-839.3610612234406,-971.9392539120105,45.13192798978323,32.38193884167701,43.36707929893993
1625961600,33515.35,34607.37,33333.33,34259.23,7023.07942,14913.795702999996,7023.07942,14913.795702999996,47.86399639728705,1748111.6421900003,4166871.2668987,4166871.2668987,1748111.6421900003,25.65116420533063,14.285714285714286,0,173.96161097056006,-754.4872401988105,-928.4488511693705,47.86399639728705,47.06901840490804,45.201201620764344
1626048000,34259.22,34670,32665,33091.1,10145.25499,13001.645088999994,10145.25499,13001.645088999994,44.1465744536056,1737966.3872000002,4161038.1247777664,4161038.1247777664,1737966.3872000002,25.44111074902497,7.142857142857143,71.42857142857143,124.69774403016186,-772.5766711316683,-897.2744151618301,44.1465744536056,21.474583698510045,33.64184698169844
1626134400,33077.43,33337.61,32201.12,32734.14,9478.05661,12319.306573999995,9478.05661,12319.306573999995,43.046347532526255,1728488.3305900001,4160450.5885142055,4160450.5885142055,1728488.3305900001,25.465024111631713,0,64.28571428571429,72.68317112838724,-806.4204512513461,-879.1036223797333,43.046347532526255,15.643341651143984,28.062314584854096
1626220800,32734.14,33125.55,31600,32816.39,10355.33307,11993.625462999993,10355.33307,11993.625462999993,43.396397760362355,1738843.66366,4166608.8060889137,4166608.8060889137,1738843.66366,25.765289298434546,0,100,49.53489535762242,-817.1850031827053,-866.7198985403277,43.396397760362355,27.95656170995172,21.69149568653533
1626307200,32815.75,33187.6,31064.77,31868.68,11273.62605,11232.046411999992,11273.62605,11232.046411999992,40.321243272228806,1727570.03761,4163873.7636446245,4163873.7636446245,1727570.03761,26.284652009719117,21.428571428571427,100,-20.149614809950208,-891.9069170527655,-871.7573022428153,40.321243272228806,16.452561586335477,20.01748831581047
1626393600,31872.49,32259.16,31025.42,31388.06,10006.49235,10817.400953999993,10006.49235,10817.400953999993,38.81890544553373,1717563.54526,4159749.7982221846,4159749.7982221846,1717563.54526,26.784982162213332,14.285714285714286,100,-85.49464032899982,-978.625602654065,-893.1309623250652,38.81890544553373,7.362381689060028,17.257168328449158
1626480000,31389.57,31949.99,31179.01,31533.91,5695.58861,10380.733177999995,5695.58861,10380.733177999995,39.55491584680473,1723259.13387,4159297.8330464866,4159297.8330464866,1723259.13387,27.24957444667225,7.142857142857143,92.85714285714286,-104.51955529394786,-1023.7804064425,-919.2608511485521,39.55491584680473,10.323454293707572,11.379465856367773
1626566400,31533.9,32450,31125.6,31788.25,5006.49746,9885.044088999995,5006.49746,9885.044088999995,40.890336574114066,1728265.63133,4159301.2352268808,4159301.2352268808,1728265.63133,27.17902165570681,0,85.71428571428571,-86.35280529737952,-1027.2018577702765,-940.849052472897,40.890336574114066,17.88413747831391,11.856657820360583
1626652800,31786.37,31887.82,30429.99,30842.03,11027.01975,9540.514437499996,11027.01975,9540.514437499996,37.56523176824307,1717238.61158,4154507.5529960566,4154507.5529960566,1717238.61158,27.499093616663135,0,100,-122.24749024145262,-1093.6584152747128,-971.4109250332601,37.56523176824307,8.823107445166015,12.343566405729247
1626739200,30842.04,31052.65,29301.56,29796.16,18114.16725,9611.185918999996,18114.16725,9611.185918999996,34.24998886739954,1699124.44433,4146626.1746053956,4146626.1746053956,1699124.44433,28.34981672359404,0,100,-196.2259800054062,-1216.6934000400179,-1020.4674200346117,34.24998886739954,8.563167644869177,11.756804189449781
1626825600,29796.15,32825,29501.02,32135.19,15598.49242,9730.562269999997,15598.49242,9730.562269999997,45.77566222924313,1714722.93675,4155750.5028870795,4155750.5028870795,1714722.93675,27.537258318650657,0,92.85714285714286,-73.73293719018761,-1112.6335915223463,-1038.9006543321586,45.77566222924313,52.78311762821226,23.38979757274923
1626912000,32152.68,32611.84,31729.68,32287.74,7704.65477,9527.511594999996,7704.65477,9527.511594999996,46.435157090204626,1722427.59152,4157793.874871741,4157793.874871741,1722427.59152,26.782739799774664,28.571428571428573,85.71428571428571,26.115374939472076,-1006.2564356578187,-1032.3718105972907,46.435157090204626,55.624725246067776,38.990336839716484
1626998400,32287.75,33647.27,32000,33647.26,9004.857,9667.863669499995,9004.857,9667.863669499995,52.03412066154951,1731432.44852,4166798.6225410667,4166798.6225410667,1731432.44852,25.260640840865555,21.428571428571427,78.57142857142857,183.50267853932417,-802.9934624231355,-986.4961409624597,52.03412066154951,80.94902802303838,63.11895696577289
1627084800,33647.27,34525,33424.7,34283.01,9864.76694,9849.899772499995,9864.76694,9849.899772499995,54.432765403395855,1741297.21546,4172324.254787237,4172324.254787237,1741297.21546,23.685858143318253,14.285714285714286,71.42857142857143,322.09625448782776,-583.8758228526749,-905.9720773405027,54.432765403395855,92.79138818725741,76.45504715212127
1627171200,34291.67,35451.04,33888.89,35428.26,9434.64435,9841.250965999994,9434.64435,9841.250965999994,58.462466548142956,1750731.85981,4181483.7383674094,4181483.7383674094,1750731.85981,22.81514586560721,100,64.28571428571429,473.42595897097794,-314.1896286267802,-787.6155875977581,58.462466548142956,99.62956217436273,91.1233261282196
1627257600,35428.25,40593.93,35251.54,37262.77,40354.55991,11343.327559499994,40354.55991,11343.327559499994,63.96045619069274,1791086.4197200001,4171513.445247288,4171513.445247288,1791086.4197200001,24.146743088061267,100,57.142857142857146,667.7133983485762,47.02616033796221,-620.687238010614,63.96045619069274,70.50078947112073,87.64057994424702
1627344000,37262.76,39550,36413.26,39470.48,24709.11876,12108.537877999994,24709.11876,12108.537877999994,69.2375079355322,1815795.53848,4194969.754323479,4194969.754323479,1815795.53848,25.38322622319718,92.85714285714286,50,901.0359433488395,505.6076911754353,-395.42825217340413,69.2375079355322,90.05124699243828,86.72719954597399
1627430400,39475.99,40925.56,38803.34,40035.1,27198.34784,12761.086926499995,27198.34784,12761.086926499995,70.4300179763834,1842993.88632,4199343.851315211,4199343.851315211,1842993.88632,26.928781263929007,100,42.857142857142854,1039.6819745436997,904.1742160062204,-135.50775853747922,70.4300179763834,92.33947006194082,84.29716884183335
1627516800,40035.1,40644.85,39229.47,40039.44,11022.43901,12896.162835999994,11022.43901,12896.162835999994,70.43950369868335,1854016.3253300001,4200936.886488723,4200936.886488723,1854016.3253300001,28.363939516037135,92.85714285714286,35.714285714285715,1073.593140807472,1206.4836674718608,132.8905266643888,70.43950369868335,92.37680660701999,91.58917455379977
1627603200,40039.44,42320.57,38342,42237.95,15063.2488,13404.012267999995,15063.2488,13404.012267999995,74.84217132538281,1869079.57413,4215374.520750908,4215374.520750908,1869079.57413,30.144534919486965,100,28.571428571428573,1177.6607108982016,1604.966415287141,427.30570438893926,74.84217132538281,99.36538953422723,94.69388873439608
1627689600,42233.66,42414.61,41064.11,41495.01,9351.95731,13520.456162499995,9351.95731,13520.456162499995,70.99415628654924,1859727.61682,4211990.365595487,4211990.365595487,1859727.61682,31.821643005325495,100,21.428571428571427,1129.8449675517354,1839.6119138286085,709.7669462768731,70.99415628654924,92.98713876634346,94.9097783025303
1627776000,41499,42605.64,39426,39865.41,10617.68715,13544.077770499996,10617.68715,13544.077770499996,63.30560519353007,1849109.9296700002,4204307.29866072,4204307.29866072,1849109.9296700002,32.0887107825072,100,14.285714285714286,930.1785710638117,1872.4901601066376,942.311589042826,63.30560519353007,79.40308536930027,90.58520455662374
1627862400,39859.18,40459.68,38690,39149.59,12379.42658,13689.146268999995,12379.42658,13689.146268999995,60.22047446694164,1836730.5030900002,4198357.80366372,4198357.80366372,1836730.5030900002,31.81546514088171,92.85714285714286,7.142857142857143,701.9972091838813,1819.8081005226777,1117.8108913387964,60.22047446694164,74.02263065164969,82.13761826243122
1627948800,39149.59,39785.3,37627.21,38191.44,15094.83164,13926.121197499995,15094.83164,13926.121197499995,56.26767539853811,1821635.6714500003,4191156.0226900387,4191156.0226900387,1821635.6714500003,30.854043994837443,85.71428571428571,0,450.83993535239324,1681.3608105292878,1230.5208751768946,56.26767539853811,66.31569629642067,73.24713743912362
1628035200,38189.4,39965.1,37509,39722.41,15327.69046,14128.824417999995,15327.69046,14128.824417999995,60.705867818744586,1836963.3619100002,4203454.620525359,4203454.620525359,1836963.3619100002,30.042228989951685,78.57142857142857,0,356.2701522926279,1675.8585655426796,1319.5884132500516,60.705867818744586,73.48988043354338,71.27606912720465
1628121600,39718.9,41447.89,37300,40888.74,28507.86981,15053.893290999995,28507.86981,15053.893290999995,63.72608031931396,1865471.2317200003,4224276.570311317,4224276.570311317,1865471.2317200003,29.91943631862738,71.42857142857143,0,340.721394464332,1745.4901563304666,1404.7687618661346,63.72608031931396,83.81144372239675,74.53900681745368
1628208000,40888.73,43399.26,39876.74,42869.58,20425.12897,15790.370308999996,20425.12897,15790.370308999996,68.196942726927,1885896.3606900002,4238559.061446569,4238559.061446569,1885896.3606900002,30.49445564274987,100,0,426.72012831521147,1938.168922260149,1511.4487939449375,68.196942726927,94.68969057281724,83.99700490958587
1628294400,42869.59,44750,42457.27,44637.34,19634.80927,16521.7858995,19634.80927,16521.7858995,71.56520227367807,1905531.1699600003,4256264.243056654,4256264.243056654,1905531.1699600003,31.432387501686232,100,0,557.2878176188342,2208.0585659684803,1650.770748349646,71.56520227367807,98.96272112150596,92.48795180557339
1628380800,44628.11,45363.83,43131.97,43829.14,18712.2859,16906.049207,18712.2859,16906.049207,68.01835080024857,1886818.8840600003,4249242.335908819,4249242.335908819,1886818.8840600003,32.475331280079054,100,0,543.2839697780632,2329.875710572225,1786.591740794162,68.01835080024857,84.82351673063172,92.82530947498505
1628467200,43829.15,46497.42,42821.3,46285.48,19464.73929,16973.577809000002,19464.73929,16973.577809000002,72.48219657242016,1906283.6233500002,4266462.667048311,4266462.667048311,1906283.6233500002,33.745613126903855,100,0,646.4966502925188,2594.7125536598105,1948.2159033672917,72.48219657242016,97.89828800812369,93.89484195342054
1628553600,46280,46718.44,44650.27,45595.66,13756.51512,16881.478944,13756.51512,16881.478944,69.54647131118585,1892527.1082300001,4265282.750398743,4265282.750398743,1892527.1082300001,34.98262972030325,100,0,615.513722819645,2717.608056891848,2102.094334072203,69.54647131118585,88.07891752774346,90.26690742216635
1628640000,45601.82,46781.09,45350.74,45553.49,11628.33477,17077.662944,11628.33477,17077.662944,69.36152095412622,1880898.77346,4256951.014188001,4256951.014188001,1880898.77346,36.14846262674832,100,57.142857142857146,541.9723940078384,2779.559826582001,2237.5874325741624,69.36152095412622,87.05212164424134,91.0097757267029
1628726400,45553.1,46223.95,43714.36,44422.14,13169.7914,17285.909664,13169.7914,17285.909664,64.4124047455739,1867728.98206,4251209.778812763,4251209.778812763,1867728.98206,35.918715625301886,92.85714285714286,50,374.86725391502114,2706.171499967939,2331.3042460529177,64.4124047455739,75.11942192300677,83.41682036499726
1628812800,44422.15,47953.9,44249.64,47833.64,11794.95661,17382.419147499997,11794.95661,17382.419147499997,71.10713058044591,1879523.93867,4262238.881253824,4262238.881253824,1879523.93867,36.28721162142119,100,42.857142857142854,446.93773288987586,2889.9764121652624,2443.0386792753866,71.10713058044591,98.8712114812416,87.01425168282996
1628899200,47833.64,48176.52,46034.93,47109.65,8130.38204,17317.206031999995,8130.38204,17317.206031999995,68.17598460256524,1871393.55663,4262268.683176233,4262268.683176233,1871393.55663,36.69905376288155,100,35.714285714285715,400.2048306551578,2943.2947175943336,2543.089886939176,68.17598460256524,90.19107214439917,88.06056851621592
1628985600,47109.64,47400,45525.19,47014.49,7745.71633,15686.763852999997,7745.71633,15686.763852999997,67.78049453911159,1863647.8403,4266828.955538708,4266828.955538708,1863647.8403,36.683560253071725,92.85714285714286,28.571428571428573,320.67640041613413,2943.9353874593435,2623.2589870432093,67.78049453911159,89.31615994821874,92.79281452461991
1629072000,47014.38,48076.52,45676.91,45902.46,10467.6749,14974.691659999997,10467.6749,14974.691659999997,63.16886922831181,1853180.1654,4258329.087135343,4258329.087135343,1853180.1654,36.909981385707745,85.71428571428571,21.428571428571427,159.13622611761366,2822.1792696902266,2663.043043572613,63.16886922831181,79.09202575823886,86.19975261695232
1629158400,45903.22,47174.62,44405.39,44671.58,12756.16226,14252.582380999997,12756.16226,14252.582380999997,58.43005714899504,1840424.0031400002,4248025.276490767,4248025.276490767,1840424.0031400002,36.151151615613756,78.57142857142857,14.285714285714286,-53.28655065068506,2596.4348552592564,2649.7214059099415,58.43005714899504,67.77517073475711,78.72778548040498
1629244800,44675.34,46035.27,44216.47,44707.98,10327.51328,14217.836094499999,10327.51328,14217.836094499999,58.52913574007924,1850751.5164200002,4243279.549061055,4243279.549061055,1850751.5164200002,35.30864692154576,71.42857142857143,7.142857142857143,-205.4697040864785,2392.8842758018436,2598.353979888322,58.52913574007924,68.10983660214853,71.65901103171491
1629331200,44709.1,47088.08,43955,46765.87,11938.13617,14061.580463,11938.13617,14061.580463,63.784473724998975,1862689.6525900003,4252762.218498425,4252762.218498425,1862689.6525900003,34.98031529782623,64.28571428571429,0,-182.44306003042811,2370.300154850287,2552.743214880715,63.784473724998975,83.00376636489166,72.96292456726583
1629417600,46769.02,49400,46644.95,49342.4,13184.68475,14253.216835,13184.68475,14253.216835,69.06944892310345,1875874.3373400003,4265395.5972165195,4265395.5972165195,1875874.3373400003,35.49584215592817,100,0,-17.291186214833942,2531.1292321121728,2548.4204183270067,69.06944892310345,99.17035517728618,83.42798604810885
1629504000,49349.99,49821.92,48285.28,48867.02,9574.85076,14201.075015499999,9574.85076,14201.075015499999,67.12314422567505,1866299.4865800003,4263070.425862395,4263070.425862395,1866299.4865800003,36.104812764091555,100,0,33.558137794099366,2590.368090569631,2556.8099527755317,67.12314422567505,86.35977956238159,89.51130036818654
1629590400,48870.21,49526.13,48102.89,49284.63,6243.41095,13894.274233999997,6243.41095,13894.274233999997,67.9768410723917,1872542.8975300002,4267195.032191355,4267195.032191355,1872542.8975300002,36.52137007977627,92.85714285714286,7.142857142857143,67.01128223191608,2640.5740555654265,2573.5627733335104,67.9768410723917,92.32510834754633,92.61841436240478
1629676800,49284.38,50505,49012.84,49506.5,10824.28276,13680.746789999996,10824.28276,13680.746789999996,68.44563845175615,1883367.1802900003,4263532.870688193,4263532.870688193,1883367.1802900003,37.22837824679632,100,0,75.1627674415613,2667.516232635462,2592.353465193901,68.44563845175615,85.29593676001085,87.99360822331299
1629763200,49504.53,49875.9,47600,47682.45,12068.35266,13517.779899999994,12068.35266,13517.779899999994,60.592188471172015,1871298.8276300002,4252338.928746429,4252338.928746429,1871298.8276300002,36.764270676395135,92.85714285714286,14.285714285714286,-63.70879741150111,2512.717468429524,2576.4262658410253,60.592188471172015,58.434698349492784,78.68524781901672
1629849600,47682.45,49277,47122.02,48987.33,9289.24621,12556.848719999995,9289.24621,12556.848719999995,63.79276748568272,1880588.0738400002,4259130.874796195,4259130.874796195,1880588.0738400002,35.98247632253362,85.71428571428571,7.142857142857143,-87.62547674481402,2466.894419910008,2554.519896654822,63.79276748568272,77.65056018283994,73.79373176411458
1629936000,48991.57,49365.1,46315.48,46851.47,11651.33499,12118.159020999996,11651.33499,12118.159020999996,55.80369947712587,1868936.7388500003,4251575.131415176,4251575.131415176,1868936.7388500003,34.68215341232258,78.57142857142857,0,-257.61718144714996,2232.498419845884,2490.115601293034,55.80369947712587,44.22091603053437,60.102058187622426
1630022400,46851.47,49185.12,46361.01,49077.57,8924.13671,11582.625392999995,8924.13671,11582.625392999995,61.25056463514133,1877860.8755600003,4259819.556001243,4259819.556001243,1877860.8755600003,33.474710709983746,71.42857142857143,42.857142857142854,-231.29737751559378,2200.993879398542,2432.291256914136,61.25056463514133,78.20717557251908,66.69288392863119
1630108800,49081.08,49309.83,48370,48942.94,4895.71626,10891.796910999994,4895.71626,10891.796910999994,60.762833385336556,1872965.1593000004,4260892.901537535,4260892.901537535,1872965.1593000004,32.42006109784712,64.28571428571429,35.714285714285715,-233.44215076600858,2140.488568456625,2373.930719222634,60.762833385336556,76.15175572519088,66.19328244274817
1630195200,48942.89,49667.1,47801,48802.58,6935.10953,10265.315422999995,6935.10953,10265.315422999995,60.22440345946552,1866030.0497700004,4261402.26658345,4261402.26658345,1866030.0497700004,30.99355319147225,57.142857142857146,28.571428571428573,-253.1491503173197,2057.494281325984,2310.6434316433038,60.22440345946552,74.00885496183209,76.12259541984741
1630281600,48802.58,48906.51,46866,46993.71,12249.25182,10189.952257999994,12249.25182,10189.952257999994,53.629024556980205,1853780.7979500005,4250686.309821972,4250686.309821972,1853780.7979500005,28.983300558991665,50,21.428571428571427,-388.73417173244206,1824.7257169777513,2213.4598887101934,53.629024556980205,46.39251908396945,65.51770992366421
1630368000,46996.8,48259.68,46708.93,47112.5,12919.45428,10254.508233499995,12919.45428,10254.508233499995,53.985410043725196,1866700.2522300004,4244491.220093033,4244491.220093033,1866700.2522300004,27.00491129388168,42.857142857142854,14.285714285714286,-465.93693981028355,1631.0387139473387,2096.9756537576222,53.985410043725196,48.20610687022901,56.20249363867691
1630454400,47110.33,49125,46537.62,48839.86,13010.85273,10246.561299999998,13010.85273,10246.561299999998,58.928535435220354,1879711.1049600004,4254634.373028313,4254634.373028313,1879711.1049600004,25.751388305702584,35.714285714285715,7.142857142857143,-398.7826018519911,1598.4974014426334,1997.2800032946245,58.928535435220354,74.57801526717559,56.39221374045809
1630540800,48834.27,50392.19,48620.73,49279.37,14120.3969,10362.833314499996,14120.3969,10362.833314499996,60.10293952688229,1893831.5018600004,4251014.081368302,4251014.081368302,1893831.5018600004,25.334081156175216,28.571428571428573,0,-325.9470399877225,1589.8462033099713,1915.7932432976938,60.10293952688229,70.7453359812103,64.50981937287169
1630627200,49279.38,51064.44,48349.66,50025,14577.24054,10685.176239499997,14577.24054,10685.176239499997,62.08374616998779,1908408.7424000003,4254428.600135711,4254428.600135711,1908408.7424000003,25.300569629276833,100,42.857142857142854,-233.0899950664707,1624.4307494646055,1857.5207445310762,62.08374616998779,78.11226036858591,74.47853720565733
1630713600,50025,50558.75,49400,49942.98,7595.50246,10677.665545999997,7595.50246,10677.665545999997,61.72074051727932,1900813.2399400002,4253951.468205559,4253951.468205559,1900813.2399400002,25.269451782871187,92.85714285714286,35.714285714285715,-184.83902239012173,1626.471966543424,1811.3109889335458,61.72074051727932,76.38514537919883,75.08091390966509
1630800000,49944.89,51907.08,49500,51789.17,7743.94916,10541.479258999996,7743.94916,10541.479258999996,66.47272527599095,1908557.1891000003,4260936.747902595,4260936.747902595,1908557.1891000003,25.915832488701113,100,28.571428571428573,-43.60052428132576,1756.8103335818887,1800.4108578632145,66.47272527599095,97.89130123757059,84.1295689951185
1630886400,51789.17,52802.03,51020.08,52698.81,9571.7692,10382.259605999996,9571.7692,10382.259605999996,68.54469430815789,1918128.9583000003,4269399.621772396,4269399.621772396,1918128.9583000003,26.90317976771137,100,21.428571428571427,88.84773921027113,1911.4705318760534,1822.6227926657823,68.54469430815789,98.40870724807483,90.89505128828148
1630972800,52698.8,52944.96,42830.77,46894.5,28990.57716,11315.412799999995,28990.57716,11315.412799999995,48.11270954977678,1889138.3811400002,4263705.003680281,4263705.003680281,1889138.3811400002,26.619489381807842,100,100,-219.82780885197076,1547.8380316008188,1767.6658404527896,48.11270954977678,40.178501689210925,78.82617005828551
1631059200,46894.49,47381.47,44423.49,46060.36,19624.56526,11699.734254499994,19624.56526,11699.734254499994,45.99101557340789,1869513.8158800001,4265799.89706242,4265799.89706242,1869513.8158800001,26.356062594897427,92.85714285714286,92.85714285714286,-471.1242634966022,1178.7605110820368,1649.884774578639,45.99101557340789,31.93127675078284,56.83949522935626
1631145600,46059.94,47400,45511.82,46400,13594.66072,11720.233052999993,13594.66072,11720.233052999993,47.01557168544506,1883108.4766000002,4264994.806995948,4264994.806995948,1883108.4766000002,26.101129948758473,85.71428571428571,85.71428571428571,-597.3015536736218,903.2578324866117,1500.5593861602335,47.01557168544506,35.28933112785109,35.79970318928167
1631232000,46396.26,47040.76,44140.48,44851.45,14905.56245,11986.768637499992,14905.56245,11986.768637499992,43.00944516248045,1868202.91415,4257397.096018962,4257397.096018962,1868202.91415,26.336855086770605,78.57142857142857,78.57142857142857,-757.5806570555678,553.5835648407738,1311.1642218963416,43.00944516248045,19.978663639896027,29.06642383951004
1631318400,44850.37,45989.94,44730.29,45171.83,6207.3979,11984.967984999992,6207.3979,11984.967984999992,44.07124568409859,1874410.31205,4255541.406083501,4255541.406083501,1874410.31205,26.555742714924722,71.42857142857143,71.42857142857143,-809.8345948455178,298.87097833944426,1108.705573184962,44.07124568409859,23.146292486101252,26.138095751282847
1631404800,45173.66,46462.98,44754.31,46024.23,6499.87249,11768.747471499993,6499.87249,11768.747471499993,46.90558360986798,1880910.18454,4258703.221423803,4258703.221423803,1880910.18454,26.452735253123265,64.28571428571429,64.28571428571429,-755.8431635145337,163.90161879179504,919.7447823063287,46.90558360986798,31.574055856178354,24.899670660725263
1631491200,46027.8,46900,43465,44947.72,15015.31735,11916.095705999993,15015.31735,11916.095705999993,43.88108656080351,1865894.8671900001,4256650.647212779,4256650.647212779,1865894.8671900001,26.831207683282944,57.142857142857146,57.142857142857146,-759.4653236339002,-29.586872236046474,729.8784513978537,43.88108656080351,20.930494681235015,25.216947674504926
1631577600,44953.23,47274.92,44679.92,47127.22,12644.17879,12083.842334999992,12644.17879,12083.842334999992,50.798314543682245,1878539.0459800002,4267855.484802561,4267855.484802561,1878539.0459800002,26.928480107983827,50,50,-589.4867604312489,-6.979999141207372,582.5067612900415,50.798314543682245,42.47942741831035,31.66132598524129
1631664000,47127.81,48475,46705,48148.12,12139.85654,12108.268412499992,12139.85654,12108.268412499992,53.6784750952414,1890678.9025200002,4275511.413313414,4275511.413313414,1890678.9025200002,26.238931641284104,42.857142857142854,42.857142857142854,-392.20476994580486,92.25079885778541,484.45556880359027,53.6784750952414,52.573167005959,38.66102970183484
1631750400,48144.03,48499.99,47020.82,47753.16,11739.29401,12249.026277499994,11739.29401,12249.026277499994,52.40048749920992,1878939.6085100002,4275396.414787075,4275396.414787075,1878939.6085100002,25.582667693519834,35.714285714285715,35.714285714285715,-277.61433161637945,137.437654283116,415.05198589949543,52.40048749920992,48.668158300368155,47.90691757487922
1631836800,47753.15,48176.64,46752.67,47303.5,9088.58404,12458.669666499994,9088.58404,12458.669666499994,50.91427184580537,1869851.02447,4273339.24959263,4273339.24959263,1869851.02447,25.100986643964706,28.571428571428573,28.571428571428573,-223.71846329917872,135.40390677552205,359.12237007470077,50.91427184580537,44.22232526776739,48.487883524698226
1631923200,47306.87,48825.62,47050,48314.56,7491.04881,12486.466630499996,7491.04881,12486.466630499996,54.06878126874831,1877342.0732800001,4276518.142192587,4276518.142192587,1877342.0732800001,24.20220408964552,21.428571428571427,21.428571428571427,-116.96044856912437,212.92180936329532,329.8822579324197,54.06878126874831,54.21877579914951,49.03641978909507
1632009600,48309.86,48379.19,46850.87,47255.92,7086.36056,12228.322067499994,7086.36056,12228.322067499994,50.41539321848256,1870255.7127200002,4273187.97188702,4273187.97188702,1870255.7127200002,23.475551486958317,14.285714285714286,14.285714285714286,-114.48273840131662,186.77883493077388,301.2615733320905,50.41539321848256,43.7518970871617,47.397666051359586
1632096000,47253.71,47358.92,42500,43012.97,27706.69089,12967.683897999994,27706.69089,12967.683897999994,39.03194747505807,1842549.0218300002,4251331.429271058,4251331.429271058,1842549.0218300002,24.575349839730535,7.142857142857143,100,-380.4500843020546,-174.30103204547777,206.14905225657685,39.03194747505807,4.911172469784482,34.29394845203195
1632182400,43007.69,43639.88,39600,40719.6,27275.3527,13680.908896499994,27275.3527,13680.908896499994,34.49782548597959,1815273.6691300003,4239174.092394756,4239174.092394756,1815273.6691300003,26.346685216614063,0,100,-675.446379214383,-638.1589217614019,37.2874574529811,34.49782548597959,12.135769736884873,20.266279764610406
1632268800,40736.81,44035.44,40570.42,43575.1,19462.553,13948.016701499995,19462.553,13948.016701499995,43.325624623427395,1834736.2221300004,4253465.309213135,4253465.309213135,1834736.2221300004,27.728874477385624,71.42857142857143,92.85714285714286,-643.0449301175624,-766.518705193972,-123.47377507640954,43.325624623427395,43.08761904348974,20.044853750053086
1632355200,43575.19,45000,43096.73,44897.59,13446.88918,13891.499133499994,13446.88918,13891.499133499994,46.89526824634657,1848183.1113100003,4265465.114247508,4265465.114247508,1848183.1113100003,28.38049528582074,64.28571428571429,85.71428571428571,-503.5029426654053,-752.8524534081662,-249.34951074276086,46.89526824634657,57.42259056843871,37.548659782937825
1632441600,44896.55,45200,40683.29,42848.92,22451.59156,14634.303588499995,22451.59156,14634.303588499995,42.43624849399928,1825731.5197500002,4264543.282282472,4264543.282282472,1825731.5197500002,29.619744835300082,57.142857142857146,78.57142857142857,-518.1143334947627,-896.9924276112142,-378.8780941164515,42.43624849399928,35.21627814715973,45.24216258636278
1632528000,42848.44,42998.76,41675,42705.51,7383.33834,14616.273047499995,7383.33834,14616.273047499995,42.13422723320065,1818348.1814100002,4268655.387214294,4268655.387214294,1818348.1814100002,30.77047655981661,50,71.42857142857143,-505.8099925972753,-1011.1405848630457,-505.33059226577035,42.13422723320065,33.66180267559255,42.10022379706371
1632614400,42705.51,43937,40803,43178.02,9971.65982,14636.267578499997,9971.65982,14636.267578499997,43.559530888382334,1828319.8412300001,4273797.251009926,4273797.251009926,1828319.8412300001,31.21850367486215,42.857142857142854,64.28571428571429,-436.82098759304256,-1051.3568267570736,-614.535839164031,43.559530888382334,38.78351807249806,35.88719963175017
1632700800,43172.17,44366.96,42111,42171.76,10094.78533,13691.477986999997,10094.78533,13691.477986999997,41.230434602726184,1818225.0559,4264246.233438796,4264246.233438796,1818225.0559,31.35478371107881,35.714285714285715,57.142857142857146,-429.2956942654929,-1151.155456995897,-721.8597627304042,41.230434602726184,27.876283653564762,33.44053480055185
1632787200,42166.31,42780,40897.7,41026.07,10491.82816,13234.841131999996,10491.82816,13234.841131999996,38.693639303943925,1807733.22774,4255185.458756881,4255185.458756881,1807733.22774,31.863024729656086,28.571428571428573,50,-468.60879811938514,-1307.6207603796356,-839.0119622602505,38.693639303943925,15.457714495069158,27.37250540704405
1632873600,41030.19,42638.99,40750.12,41522.16,10303.31567,13070.273879499997,10303.31567,13070.273879499997,40.40352132164987,1818036.54341,4253304.71513246,4253304.71513246,1818036.54341,32.38048989504313,21.428571428571427,42.857142857142854,-429.3758257069277,-1375.73174439391,-946.3559186869824,40.40352132164987,20.835022470034566,21.389673539556213
1632960000,41519.11,44110.17,41409.67,43824.43,12835.99813,12966.795663499997,12835.99813,12966.795663499997,47.69453836409373,1830872.54154,4263424.358435083,4263424.358435083,1830872.54154,31.866590412074242,14.285714285714286,35.714285714285715,-226.7235292295868,-1229.7603302239659,-1003.0368009943791,47.69453836409373,45.7902016341449,27.36097953308293
1633046400,43828.89,48500,43287.44,48165.76,20095.34602,13661.193069499996,20095.34602,13661.193069499996,58.10329032147514,1850967.88756,4280942.595144601,4280942.595144601,1850967.88756,29.96729812366961,7.142857142857143,28.571428571428573,198.37825973343092,-755.0639763275904,-953.4422360610213,58.10329032147514,92.84752677868805,53.15758362762256
1633132800,48165.76,48359.33,47451,47657.69,7262.64874,13699.331881999995,7262.64874,13699.331881999995,56.681682549067,1843705.2388199999,4276985.169986494,4276985.169986494,1843705.2388199999,28.203669570151025,0,21.428571428571427,430.6930196997148,-415.07596143637784,-845.7689811360926,56.681682549067,90.53584269662925,76.39119036982079
1633219200,47663.74,49300,47120.11,48233.99,7989.27375,13348.029701999996,7989.27375,13348.029701999996,57.93878487147304,1851694.5125699998,4277160.613029222,4277160.613029222,1851694.5125699998,26.951845690510044,100,14.285714285714286,598.2146047987002,-98.00072513771738,-696.2153299364176,57.93878487147304,89.01020618556699,90.79785855362815
1633305600,48233.99,49505,46916.7,49245.54,13938.65627,13412.753575999997,13938.65627,13412.753575999997,60.12609916879662,1865633.1688399997,4288304.752623555,4288304.752623555,1865633.1688399997,25.873698455145632,100,7.142857142857143,742.7565109219951,232.23030871607625,-510.5262022059188,60.12609916879662,97.38051489146896,92.30885459122179
1633392000,49244.13,51906.23,49057.18,51493.99,17828.61151,13697.191324499998,17828.61151,13697.191324499998,64.54023590359428,1883461.7803499997,4300973.983421471,4300973.983421471,1883461.7803499997,25.771636491296796,100,0,942.5612499340154,667.6753602116005,-274.88588972241496,64.54023590359428,96.36338294308034,94.25136800670549
1633478400,51499.77,55757.11,50416.01,55339.48,23465.87817625,14283.520532812498,23465.87817625,14283.520532812498,70.54584155600492,1906927.6585262497,4320770.185050663,4320770.185050663,1906927.6585262497,26.744562572162607,100,0,1266.3006414752413,1307.9899121216367,41.689270646395414,70.54584155600492,97.22943487450429,96.99111090301794
1633564800,55346.95,55356.85,53379,53797.82,15789.1160021,14618.547130917499,15789.1160021,14618.547130917499,65.73893958729215,1891138.5425241496,4311667.923525899,4311667.923525899,1891138.5425241496,27.647993932966575,92.85714285714286,7.142857142857143,1304.0674354064536,1671.7735649044625,367.70612949800886,65.73893958729215,87.00203399005693,93.5316172692139
1633651200,53805.46,56113,53634.41,53963.82,12295.22341383,14858.755861108997,12295.22341383,14858.755861108997,66.00752400524523,1903433.7659379796,4302640.823960506,4302640.823960506,1903433.7659379796,28.673527560560085,100,0,1266.6189859448987,1950.9798619291323,684.3608759842335,66.00752400524523,86.01056572725948,90.08067819727363
1633737600,53965.18,55500,53675,54962.29,7048.02503382,14856.839084799998,7048.02503382,14856.839084799998,67.65024074072423,1910481.7909717995,4305535.650593301,4305535.650593301,1910481.7909717995,29.625808786182628,92.85714285714286,28.571428571428573,1234.2295984062177,2227.1478739920058,992.918275585788,67.65024074072423,92.50980284946573,88.50746752226077
1633824000,54963.29,56545.24,54112.95,54690.53,9327.90666914,13937.899873756996,9327.90666914,13937.899873756996,66.70536254407742,1901153.8843026594,4300637.817915307,4300637.817915307,1901153.8843026594,30.77786544510112,100,21.428571428571427,1122.8328680613217,2396.4593606624403,1273.6264926011186,66.70536254407742,88.25770237896262,88.926023651896
1633910400,54683.09,57833.23,54411.54,57487.44,13399.74369708,13244.119423610997,13399.74369708,13244.119423610997,71.16859876131022,1914553.6279997395,4311329.252342399,4311329.252342399,1914553.6279997395,32.15376900284437,100,14.285714285714286,1161.031653746423,2724.9160597841474,1563.8844060377244,71.16859876131022,97.97583695240503,92.91444739361118
1633996800,57485.97,57674.55,53999.11,56005.1,15191.03140111,13030.543343666495,15191.03140111,13030.543343666495,66.11036217777203,1899362.5965986294,4312720.212256785,4312720.212256785,1899362.5965986294,33.147138177690834,92.85714285714286,7.142857142857143,1015.2536033830829,2832.951410266578,1817.697806883495,66.11036217777203,89.29861131843086,91.84405021659957
1634083200,56005.1,57771.33,54236.09,57367.32,14637.12188496,13090.054978914497,14637.12188496,13090.054978914497,68.33746617626288,1913999.7184835894,4324011.850603008,4324011.850603008,1913999.7184835894,34.09520449465829,85.71428571428571,0,941.0235681574086,2993.977267080256,2052.9536989228473,68.33746617626288,97.1631607276376,94.81253633282456
1634169600,57367.32,58520.71,56832.32,57359.51,11970.87561874,12566.019181851496,11970.87561874,12566.019181851496,68.30974927170644,1902028.8428648494,4319516.648161015,4319516.648161015,1902028.8428648494,35.17685753196312,100,0,825.952806789041,3085.3947074091484,2259.4419006201074,68.30974927170644,92.37721119628289,92.94632774745052
1634256000,57359.51,62910,56867.11,61695.39,26375.18299902,13515.611414802497,26375.18299902,13515.611414802497,74.4945962702938,1928404.0258638693,4335289.102656805,4335289.102656805,1928404.0258638693,37.08454953131452,100,0,966.6377035755304,3467.7390300895204,2501.10132651399,74.4945962702938,92.40550730618446,93.98195974336839
1634342400,61690.32,62350,60139.01,60877.42,10114.41151289,13522.748999446998,10114.41151289,13522.748999446998,71.6535028377697,1918289.6143509794,4331930.563043139,4331930.563043139,1918289.6143509794,38.85597781642654,92.85714285714286,14.285714285714286,929.1405277988715,3662.526986262579,2733.3864584637076,71.6535028377697,87.29105312849754,90.6912572103217
1634428800,60867.05,61744.17,58943.83,61527.11,8780.64185921,13457.041825907498,8780.64185921,13457.041825907498,72.54901635629993,1927070.2562101895,4339349.994390797,4339349.994390797,1927070.2562101895,39.657502520619246,85.71428571428571,7.142857142857143,873.4728780853425,3825.2275560703856,2951.754677985043,72.54901635629993,91.35331670136871,90.34995904535032
1634515200,61530.07,62675.19,59887.74,62042.41,19678.90915373,13916.395875593997,19678.90915373,13916.395875593997,73.270299014541,1946749.1653639195,4350094.271436832,4350094.271436832,1946749.1653639195,40.60737918800575,78.57142857142857,0,798.767240298163,3950.2137283577467,3151.4464880595838,73.270299014541,93.73708746666746,90.79381909884465
1634601600,62042.4,64500,61333,64303.14,17254.36873116,14263.948528651998,17254.36873116,14263.948528651998,76.22214377959683,1964003.5340950794,4365203.584892705,4365203.584892705,1964003.5340950794,41.853997336534285,100,0,825.6138662341868,4183.463820852317,3357.8499546181306,76.22214377959683,98.60224268832908,94.56421561878848
1634688000,64303.14,66999,63525,66026.54,18684.58296597,14556.377770450496,18684.58296597,14556.377770450496,78.19867791717681,1982688.1170610494,4373427.59816893,4373427.59816893,1982688.1170610494,43.42480542373122,100,0,878.5312528793143,4456.0140207172735,3577.4827678379593,78.19867791717681,92.86005873715119,95.06646296404932
1634774400,66021.26,66650.85,62050,62204.02,22629.21389497,14683.071164198996,22629.21389497,14683.071164198996,65.24415073661623,1960058.9031660794,4352313.4745395,4352313.4745395,1960058.9031660794,43.93998029034997,92.85714285714286,0,589.0852618589879,4313.839345161694,3724.754083302706,65.24415073661623,64.12175756981692,85.19468633176581
1634860800,62204.01,63750,60000,60687.64,16921.74264238,15166.025859317999,16921.74264238,15166.025859317999,60.93184587952789,1943137.1605236994,4341597.634356109,4341597.634356109,1943137.1605236994,43.25989118709802,85.71428571428571,0,246.05559829988852,4032.3235811775667,3786.267982877678,60.93184587952789,52.63164214950465,69.87115281882434
1634947200,60682.88,61750,59650,61300.01,6704.66319167,15101.7953314015,6704.66319167,15101.7953314015,62.02347139698431,1949841.8237153694,4345428.934319571,4345428.934319571,1949841.8237153694,42.44200122364084,78.57142857142857,0,22.713950046527316,3814.6604204358373,3791.94647038931,62.02347139698431,56.16124444129913,57.638214720206975
1635033600,61300.02,61491.96,59522.89,60854.48,8543.97326976,14832.061181389503,8543.97326976,14832.061181389503,60.69470295026423,1941297.8504456095,4348440.740545999,4348440.740545999,1941297.8504456095,41.61159143470817,71.42857142857143,14.285714285714286,-181.46610693877437,3565.113836715842,3746.5799436546163,60.69470295026423,52.73406159590583,53.84231606223662
1635120000,60847.91,63726.58,60653.5,63083.54,10440.25786432,14462.643499105503,10440.25786432,14462.643499105503,64.76223581918525,1951738.1083099295,4354511.764015463,4354511.764015463,1951738.1083099295,41.45744071940508,64.28571428571429,7.142857142857143,-191.83291032563557,3506.788805747572,3698.6217160732076,64.76223581918525,69.88082206849442,59.592042701899885
1635206400,63081.96,63290.49,59837.07,60337.62,12046.4333987,13891.671260228006,12046.4333987,13891.671260228006,56.94447488324692,1939691.6749112294,4345957.429601375,4345957.429601375,1939691.6749112294,40.84791486794004,57.142857142857146,0,-397.2322513129643,3202.0814019320023,3599.3136532449666,56.94447488324692,47.80673059670564,56.80720475370205
1635292800,60333.19,61488,58100,58455.47,18714.23723745,14037.927321995507,18714.23723745,14037.927321995507,52.285475537595225,1920977.4376737794,4331170.199395091,4331170.199395091,1920977.4376737794,39.36201836948223,50,0,-658.077679470905,2776.7165539063353,3434.7942333772403,52.285475537595225,15.965388897850639,44.55098052101699
1635379200,58462.73,62477.47,57653.88,60591.65,18592.15161459,14352.773732033509,18592.15161459,14352.773732033509,56.62324450474919,1939569.5892883695,4335224.858661523,4335224.858661523,1939569.5892883695,38.3026483698112,42.857142857142854,0,-682.0613673321286,2582.2175242120793,3264.278891544208,56.62324450474919,36.76056490940981,33.51089480132212
1635465600,60591.63,62974,60188.73,62276.72,15445.29573705,14772.637267195008,15445.29573705,14772.637267195008,59.73302415433554,1955014.8850254195,4342936.831732167,4342936.831732167,1955014.8850254195,37.47756940360617,35.714285714285715,0,-583.561671102781,2534.8268026657315,3118.3884737685125,59.73302415433554,49.467957607821006,34.064637138360574
1635552000,62287.95,62379.2,60763.25,61279.47,4751.63654101,14543.82376078851,4751.63654101,14543.82376078851,57.11140748320779,1950263.2484844094,4341193.932801536,4341193.932801536,1950263.2484844094,36.711424649272914,28.571428571428573,85.71428571428571,-583.5988198130722,2388.889949002172,2972.4887688152444,57.11140748320779,38.74728200386942,41.6586015070335