time,open,high,low,close,Volume,Volume MA,Volume,Volume MA,RSI,OnBalanceVolume,Accumulation/Distribution,Accumulation/Distribution,OnBalanceVolume,ADX,Aroon Up,Aroon Down,Histogram,MACD,Signal,RSI,%K,%D
2016-05-23T00:00:00Z,13.91,13.91,10.25,12.34,53831,NaN,53831,NaN,NaN,NaN,7648.120218579228,7648.120218579228,NaN,NaN,NaN,NaN,NaN,NaN,NaN,NaN,NaN,NaN
2016-05-30T00:00:00Z,12.35,14.45,12,14.04,49575,NaN,49575,NaN,NaN,49575,40630.67123898738,40630.67123898738,49575,NaN,NaN,NaN,NaN,NaN,NaN,NaN,NaN,NaN
2016-06-06T00:00:00Z,14.02,15.91,13.76,15.58,84252,NaN,84252,NaN,NaN,133827,99019.26658782452,99019.26658782452,133827,NaN,NaN,NaN,NaN,NaN,NaN,NaN,NaN,NaN
2016-06-13T00:00:00Z,15.91,22,10,12.35,340071,NaN,340071,NaN,NaN,-206244,-107857.2584121755,-107857.2584121755,-206244,NaN,NaN,NaN,NaN,NaN,NaN,NaN,NaN,NaN
2016-06-20T00:00:00Z,12.35,15.89,10.8,14.02,219283,NaN,219283,NaN,NaN,13039,-49697.72010176302,-49697.72010176302,13039,NaN,NaN,NaN,NaN,NaN,NaN,NaN,NaN,NaN
2016-06-27T00:00:00Z,14,14.59,11.52,12.02,133884,NaN,133884,NaN,NaN,-120845,-139971.2966489943,-139971.2966489943,-120845,NaN,NaN,NaN,NaN,NaN,NaN,NaN,NaN,NaN
2016-07-04T00:00:00Z,11.94,11.99,9.31,11.02,122035,NaN,122035,NaN,NaN,-242880,-106275.06530571077,-106275.06530571077,-242880,NaN,NaN,NaN,NaN,NaN,NaN,NaN,NaN,NaN
2016-07-11T00:00:00Z,11,12.75,10.11,11.33,100539,NaN,100539,NaN,NaN,-142341,-113891.65621480165,-113891.65621480165,-142341,NaN,NaN,NaN,NaN,NaN,NaN,NaN,NaN,NaN
2016-07-18T00:00:00Z,11.27,15.39,11,12.78,589591,NaN,589591,NaN,NaN,447250,-225363.30313963105,-225363.30313963105,447250,NaN,NaN,NaN,NaN,NaN,NaN,NaN,NaN,NaN
2016-07-25T00:00:00Z,12.71,14.01,11.61,11.99,593186,NaN,593186,NaN,NaN,-145936,-630707.0698062973,-630707.0698062973,-145936,NaN,NaN,NaN,NaN,NaN,NaN,NaN,NaN,NaN
2016-08-01T00:00:00Z,11.98,12.12,6.68,10.99,713811,NaN,713811,NaN,NaN,-859747,-213442.55142394413,-213442.55142394413,-859747,NaN,NaN,NaN,NaN,NaN,NaN,NaN,NaN,NaN
2016-08-08T00:00:00Z,10.99,12.91,10.94,11.28,401666,NaN,401666,NaN,NaN,-458081,-476462.41944424884,-476462.41944424884,-458081,NaN,NaN,NaN,NaN,NaN,NaN,NaN,NaN,NaN
2016-08-15T00:00:00Z,11.28,11.52,10.65,11.21,242261,NaN,242261,NaN,NaN,-700342,-406847.1895591908,-406847.1895591908,-700342,NaN,NaN,NaN,NaN,NaN,NaN,NaN,NaN,NaN
2016-08-22T00:00:00Z,11.17,11.47,10.85,11.01,188275,NaN,188275,NaN,NaN,-888617,-497947.9960108038,-497947.9960108038,-888617,NaN,NaN,NaN,NaN,NaN,NaN,NaN,28.263707571801564,NaN
2016-08-29T00:00:00Z,11.01,12.5,10.8,11.77,279688,NaN,279688,NaN,48.219862585883824,-608929,-458462.6313049217,-458462.6313049217,-608929,NaN,21.428571428571427,71.42857142857143,NaN,NaN,NaN,48.219862585883824,33.224543080939945,NaN
2016-09-05T00:00:00Z,11.77,12.21,11.31,11.65,173214,NaN,173214,NaN,47.83375434917306,-782143,-500803.8313049218,-500803.8313049218,-782143,NaN,14.285714285714286,64.28571428571429,NaN,NaN,NaN,47.83375434917306,32.44125326370757,31.30983463881636
2016-09-12T00:00:00Z,11.64,12.99,11.64,12.64,243440,NaN,243440,NaN,51.2984456987168,-538703,-383591.97945306986,-383591.97945306986,-538703,NaN,7.142857142857143,57.142857142857146,NaN,NaN,NaN,51.2984456987168,38.90339425587468,34.85639686684073
2016-09-19T00:00:00Z,12.64,15.25,12.33,13.12,380831,NaN,380831,NaN,52.930756716770745,-157872,-558356.8904119742,-558356.8904119742,-157872,NaN,0,50,NaN,NaN,NaN,52.930756716770745,69.92399565689468,47.08954772549231
2016-09-26T00:00:00Z,13.14,13.58,12.83,13.28,218094,NaN,218094,NaN,53.49034248462495,60222,-514738.0904119746,-514738.0904119746,60222,NaN,0,42.857142857142854,NaN,NaN,NaN,53.49034248462495,75.77497129735934,61.53412040337624
2016-10-03T00:00:00Z,13.29,13.58,12.02,12.1,286944,270723.55,286944,270723.55,48.87539821409201,-226722,-772251.9365658207,-772251.9365658207,-226722,NaN,21.428571428571427,35.714285714285715,NaN,NaN,NaN,48.87539821409201,62.22732491389207,69.30876395604871
2016-10-10T00:00:00Z,12.1,12.24,11.62,11.95,230228,279543.4,230228,279543.4,48.30487154654381,-456950,-757398.5172109824,-757398.5172109824,-456950,NaN,14.285714285714286,28.571428571428573,NaN,NaN,NaN,48.30487154654381,60.505166475315725,66.16915422885572
2016-10-17T00:00:00Z,11.95,12.94,11.83,11.94,210400,287584.65,210400,287584.65,48.264422696393304,-667350,-926097.6163100817,-926097.6163100817,-667350,NaN,7.142857142857143,21.428571428571427,NaN,NaN,NaN,48.264422696393304,60.39035591274396,61.040949100650586
2016-10-24T00:00:00Z,11.93,11.99,9.52,11.19,363361,301540.1,363361,301540.1,45.206924840955665,-1030711,-798112.1628687863,-798112.1628687863,-1030711,NaN,0,14.285714285714286,NaN,NaN,NaN,45.206924840955665,52.62543757292882,57.84031998699618
2016-10-31T00:00:00Z,11.2,11.44,10.35,11.01,274366,298254.85,274366,298254.85,44.47866441914135,-1305077,-740218.41974952,-740218.41974952,-1305077,NaN,57.142857142857146,7.142857142857143,NaN,NaN,NaN,44.47866441914135,50.52508751458576,54.51362700008619
2016-11-07T00:00:00Z,11.01,11.06,9.65,10.14,286697,301625.55,286697,301625.55,41.03758300560002,-1591774,-827650.8381892362,-827650.8381892362,-1591774,NaN,50,0,NaN,NaN,NaN,41.03758300560002,10.820244328097747,37.99025647187079
2016-11-14T00:00:00Z,10.13,10.42,9.45,9.6,256508,307756.75,256508,307756.75,39.0197426600761,-1848282,-1004826.4670552155,-1004826.4670552155,-1848282,NaN,42.857142857142854,100,NaN,-0.6874599180245262,NaN,39.0197426600761,2.58620689655173,21.310512913078423
2016-11-21T00:00:00Z,9.58,10.21,8.66,8.98,257483,314529.15,257483,314529.15,36.7833943612152,-2105765,-1155993.905764893,-1155993.905764893,-2105765,NaN,35.714285714285715,100,NaN,-0.82368238954475,NaN,36.7833943612152,4.855842185128988,6.087431136592833
2016-11-28T00:00:00Z,8.97,9,7.27,7.37,452048,332104.6,452048,332104.6,31.702225143382122,-2557813,-1555782.021371829,-1555782.021371829,-2557813,22.901494895174874,28.571428571428573,100,NaN,-1.049455751681169,NaN,31.702225143382122,1.253132832080207,2.898393971253652
2016-12-05T00:00:00Z,7.39,8.95,5.81,8.23,550672,330158.65,550672,330158.65,36.72990483438063,-2007141,-1257647.499078835,-1257647.499078835,-2007141,22.38922073073742,21.428571428571427,100,NaN,-1.1457801151592033,NaN,36.72990483438063,25.63559322033899,10.581522745849405
2016-12-12T00:00:00Z,8.23,8.62,7.51,7.92,282767,314637.7,282767,314637.7,35.709453777302656,-2289908,-1331523.5621418979,-1331523.5621418979,-2289908,21.913537578045503,14.285714285714286,92.85714285714286,NaN,-1.2329199427826296,NaN,35.709453777302656,22.35169491525424,16.413473655891156
2016-12-19T00:00:00Z,7.92,7.97,7.01,7.19,354826,296688.45,354826,296688.45,33.35910346768394,-2644734,-1553289.8121418974,-1553289.8121418974,-2644734,21.691410391961497,7.142857142857143,85.71428571428571,NaN,-1.345375136017136,NaN,33.35910346768394,14.618644067796618,20.868644067796627
2016-12-26T00:00:00Z,7.18,8.6,7.02,8.18,492137,301212,492137,301212,39.20331966748223,-2152597,-1322795.2678381,-1322795.2678381,-2152597,21.084911247942497,0,78.57142857142857,NaN,-1.339174787286142,NaN,39.20331966748223,30.5019305019305,22.490756494993793
2017-01-02T00:00:00Z,8.2,11.8,8.05,10.5,1100696,344133.75,1100696,344133.75,50.220562070182275,-1051901,-985248.494504767,-985248.494504767,-1051901,20.294215520398517,0,71.42857142857143,NaN,-1.1339844879979122,NaN,50.220562070182275,60.36036036036037,35.160311643362505
2017-01-09T00:00:00Z,10.5,10.94,9.12,9.9,499774,359708.7,499774,359708.7,47.80766645933381,-1551675,-1056644.7802190522,-1056644.7802190522,-1551675,19.559998059107677,0,64.28571428571429,0.07694743186233222,-1.0081632052165599,-1.085110637078892,47.80766645933381,57.36325385694251,49.408514906411135
2017-01-16T00:00:00Z,9.91,11.07,9.56,10.77,386796,365064.1,386796,365064.1,51.45014956653271,-1164879,-823542.5550534897,-823542.5550534897,-1164879,18.93973664849319,7.142857142857143,57.142857142857146,0.205132886995822,-0.8286945283341147,-1.0338274153299367,51.45014956653271,69.56521739130434,62.429610536202425
2017-01-23T00:00:00Z,10.77,10.92,10.42,10.49,257735,369290.15,257735,369290.15,50.23502468543834,-1422614,-1009111.7550534895,-1009111.7550534895,-1422614,18.363779624351164,0,50,0.26627990334254614,-0.7009775361517541,-0.9672574394943002,50.23502468543834,75.72815533980582,67.55220886268424
2017-01-30T00:00:00Z,10.5,11.45,10.37,11.26,333757,373806,333757,373806,53.48825130429127,-1088857,-792787.7735720077,-792787.7735720077,-1088857,18.10455326488459,0,42.857142857142854,0.348604738616501,-0.531501516223674,-0.880106254840175,53.48825130429127,90.98497495826376,78.75944922979133
2017-02-06T00:00:00Z,11.28,11.65,10.61,11.5,432685,376398.7,432685,376398.7,54.486943657999134,-656172,-484915.7543412386,-484915.7543412386,-656172,17.96913845382587,64.28571428571429,35.714285714285715,0.4052699140729542,-0.37351886224898223,-0.7787887763219364,54.486943657999134,94.99165275459097,87.23492768422021
2017-02-13T00:00:00Z,11.5,14.7,11.21,12.9,658471,398417.55,658471,398417.55,59.89640300744323,2299,-505669.8546277714,-505669.8546277714,2299,19.166965408376686,100,28.571428571428573,0.5159864276504688,-0.13380574175885052,-0.6497921694093193,59.89640300744323,79.75253093363331,88.57638621549603
2017-02-20T00:00:00Z,12.9,14.84,12.3,14.74,684462,418293.45,684462,418293.45,65.67136199825005,686761,124897.49970293744,124897.49970293744,686761,20.329640736268733,100,21.428571428571427,0.6816810648595699,0.20230916166514312,-0.4793719031944268,65.67136199825005,98.8925802879291,91.21225465871782
2017-02-27T00:00:00Z,14.74,21.49,14.37,19.4,1863151,499939.6,1863151,499939.6,75.35193692903164,2549912,894232.3227366457,894232.3227366457,2549912,23.051508657784296,100,14.285714285714286,1.0515610611068855,0.83507942318918,-0.21648163791770542,75.35193692903164,86.67091836734694,88.43867652963648
2017-03-06T00:00:00Z,19.39,24.25,16.2,23.39,1555546,567196.9,1555546,567196.9,80.43844385988072,4105458,2117413.214662112,2117413.214662112,4105458,25.986658456359546,100,7.142857142857143,1.484876208945574,1.6396136232642622,0.15473741431868815,80.43844385988072,95.33622559652929,93.63324141726848
2017-03-13T00:00:00Z,23.38,57.67,23.38,43.21,3720266,735042.15,3720266,735042.15,90.70249382265024,7825724,2700027.050182672,2700027.050182672,7825724,30.355586447533618,100,0,2.9420854697834473,3.8323442515479975,0.8902587817645501,90.70249382265024,71.45677062771418,84.48797153053015
2017-03-20T00:00:00Z,43.21,53.44,38.26,50.68,1597442,801195.95,1597442,801195.95,92.33492041389798,9423166,3716581.0501826727,3716581.0501826727,9423166,34.41244815362383,92.85714285714286,7.142857142857143,4.1698086510902,6.1025195956272995,1.9327109445370998,92.33492041389798,86.20213185945518,84.3317093612329
2017-03-27T00:00:00Z,50.74,53.97,46.98,48.74,1170185,845370.35,1170185,845370.35,88.01297101403543,8252981,3135673.7611984108,3135673.7611984108,8252981,38.19023875331551,85.71428571428571,0,4.579307071844919,7.656844784343249,3.07753771249833,88.01297101403543,82.36920039486672,80.00936762734538
2017-04-03T00:00:00Z,48.74,48.97,41.1,43.92,1102991,887694.5,1102991,887694.5,78.21705304596442,7149990,2823136.2859760476,2823136.2859760476,7149990,40.06176901810334,78.57142857142857,0,4.260259441543203,8.402862014427335,4.142602572884131,78.21705304596442,72.2893994357114,80.28691056334445
2017-04-10T00:00:00Z,43.93,74.98,42.72,48.13,588168,904228.75,588168,904228.75,80.28144985153591,7738158,2432239.7602475914,2432239.7602475914,7738158,42.736015072537676,100,0,4.06786177594776,9.227429792818832,5.159568016871072,80.28144985153591,59.23170361372609,71.29676781476807
2017-04-17T00:00:00Z,48.19,50.32,47.25,48.96,522822,907767.45,522822,907767.45,80.67038784073875,8260980,2491844.8742541065,2491844.8742541065,8260980,45.219243551655275,92.85714285714286,0,3.7399564746303087,9.834513610158957,6.094557135528649,80.67038784073875,60.22623051054723,63.91577785332825
2017-04-24T00:00:00Z,48.95,82.9,48.94,80.87,1616245,961046.1,1616245,961046.1,89.3597798942799,9877225,3914863.8819101723,3914863.8819101723,9877225,48.08509703310141,100,0,5.3192358243262365,12.743601915936445,7.424366091610208,89.3597798942799,97.2011581414587,72.21969742191068
2017-05-01T00:00:00Z,80.72,98.98,72.24,93.82,1684885,1031152,1684885,1031152,91.10698175380203,11562110,4949486.608162976,4949486.608162976,11562110,50.90987145245567,100,7.142857142857143,6.789006611426949,15.910624355893894,9.121617744466946,91.10698175380203,94.176729488771,83.86803938025899
2017-05-08T00:00:00Z,93.83,94.74,75.89,89.39,1008346,1063828,1008346,1063828,85.90995893273919,10553764,5385455.833627167,5385455.833627167,10553764,53.53287627042748,92.85714285714286,0,6.988467223192208,17.857201773457206,10.868734550264998,85.90995893273919,89.14790087133642,93.50859616718873
2017-05-15T00:00:00Z,89.42,148.97,82.5,148.78,1588938,1118668.05,1588938,1118668.05,92.27334898082643,12142702,6965310.089983419,6965310.089983419,12142702,56.30365771845604,100,0,10.438181146613207,23.916460983531508,13.4782798369183,92.27334898082643,99.86207897793264,94.39556977934672
2017-05-22T00:00:00Z,148.86,217.85,115.67,175.48,2851967,1206231.6,2851967,1206231.6,93.65968822970238,14994669,7452081.5176600665,7452081.5176600665,14994669,59.06384076598279,100,0,13.634261017202384,30.52110610842128,16.886845091218895,93.65968822970238,79.38701045974216,89.46566343633708
2017-05-29T00:00:00Z,175.48,249.04,167,245.5,1853779,1273931.85,1853779,1273931.85,95.79199601394883,16848448,9145880.56495407,9145880.56495407,16848448,61.67841797013599,100,0,19.2373301468924,40.933507774834396,21.696177627941996,95.79199601394883,98.49149870030256,92.58019604599247
2017-06-05T00:00:00Z,245.48,358.46,241.2,343.01,1691595,1339171.8,1691595,1339171.8,97.2028169586003,18540043,10391711.574676055,10391711.574676055,18540043,64.21467984173287,100,0,27.765833182275795,56.40346910578674,28.637635923510945,97.2028169586003,95.48588792146322,91.121465693836
2017-06-12T00:00:00Z,343.29,420,253,351.85,2460293,1449299.7,2460293,1449299.7,97.29147465676294,21000336,10843992.982460488,10843992.982460488,21000336,66.6049730345582,100,0,31.958867091891847,68.58621978837576,36.62735269648391,97.29147465676294,82.81730623770864,92.26489761982482
2017-06-19T00:00:00Z,351.84,365.79,13,278.49,1249599,1495091.8,1249599,1495091.8,75.81579183805275,19750737,11475150.458040861,11475150.458040861,19750737,62.84112692257581,92.85714285714286,100,27.896054490740767,71.49742080990987,43.6013663191691,75.81579183805275,65.23095823095824,81.17805079671005
2017-06-26T00:00:00Z,278.49,323.69,206.5,285,2216296,1584272.35,2216296,1584272.35,76.31541698313025,21967033,12228036.743218778,12228036.743218778,21967033,59.3461269614493,85.71428571428571,92.85714285714286,23.90515264713902,73.48280712809287,49.57765448095385,76.31541698313025,66.83046683046683,71.62624376637791
2017-07-03T00:00:00Z,285,285,231.25,238.81,826848,1592691.2,826848,1592691.2,65.9109126097679,21140185,11633783.008521104,11633783.008521104,21140185,56.100769854688956,78.57142857142857,85.71428571428571,16.750857180931632,70.5162259571184,53.76536877618676,65.9109126097679,55.481572481572485,62.514332514332544
2017-07-10T00:00:00Z,238.4,240.33,130.26,155.68,2651907,1691063.45,2651907,1691063.45,52.13468345695174,18488278,10206759.735967275,10206759.735967275,18488278,52.581934857775856,71.42857142857143,78.57142857142857,5.593244774155096,60.75692474388063,55.163679969725536,52.13468345695174,35.056511056511056,52.456183456183474
2017-07-17T00:00:00Z,155.69,249.4,153.25,228.31,3474296,1771620.7,3474296,1771620.7,60.00090457480659,21962574,12156918.395561658,12156918.395561658,21962574,49.18233460237861,64.28571428571429,71.42857142857143,2.438822525612615,58.2122081267413,55.77338560112869,60.00090457480659,52.9017199017199,47.81326781326783
2017-07-24T00:00:00Z,228.27,229.99,178.03,196.95,1328893,1760288.05,1328893,1760288.05,55.74132080778228,20633681,11795795.047601689,11795795.047601689,20633681,46.02556293665259,57.142857142857146,64.28571428571429,-2.1759525828609796,53.05344487255246,55.22939745541344,55.74132080778228,45.1965601965602,44.384930384930406
2017-07-31T00:00:00Z,196.95,273,190.78,263.96,1474401,1647994.8,1474401,1647994.8,61.95630839031086,22108082,12945978.45966688,12945978.45966688,22108082,43.033681308215805,50,57.142857142857146,-1.181431409632701,53.752608193372566,54.93403960300527,61.95630839031086,61.66093366093365,53.25307125307126
2017-08-07T00:00:00Z,263.97,319.7,257.1,296.66,1558832,1646064.3,1558832,1646064.3,64.57084893115186,23666914,13357350.73826113,13357350.73826113,23666914,40.88730548553744,42.857142857142854,50,1.0898622351474998,56.296367396939644,55.206505161792144,64.57084893115186,69.6953316953317,58.850941850941865
2017-08-14T00:00:00Z,296.67,309.41,267,297.79,828560,1628983.05,828560,1628983.05,64.6612304272837,24495474,13731873.143354269,13731873.143354269,24495474,38.894242221621816,35.714285714285715,42.857142857142854,2.0251395006950546,57.73792953766096,55.712790036965906,64.6612304272837,69.97297297297298,67.10974610974613
2017-08-21T00:00:00Z,297.79,348.2,292,348.2,968295,1622248.25,968295,1622248.25,68.51942696098361,25463769,14700168.143354269,14700168.143354269,25463769,37.55091094459643,28.571428571428573,35.714285714285715,5.214317573314368,62.230687003608864,57.016369430294496,68.51942696098361,82.35872235872236,74.00900900900903
2017-08-28T00:00:00Z,348.2,396.88,333,353.06,1158787,1650779.2,1158787,1650779.2,68.87227246977915,26622556,14269160.329954144,14269160.329954144,26622556,36.87069476271399,21.428571428571427,28.571428571428573,6.73023595066573,65.42916436862666,58.69892841796093,68.87227246977915,83.55282555282555,78.62817362817366
2017-09-04T00:00:00Z,353.06,353.15,285,300.33,1592949,1704285.55,1592949,1704285.55,60.89702404654164,25029607,13392863.073754583,13392863.073754583,25029607,35.36627385704202,14.285714285714286,21.428571428571427,3.427321792795553,62.98308065895537,59.55575886615982,60.89702404654164,70.5970515970516,78.83619983619985
2017-09-11T00:00:00Z,300.34,316.19,202.25,259.66,2159003,1731423.45,2159003,1731423.45,55.5536734241096,22870604,13409537.838016476,13409537.838016476,22870604,32.956032114710254,7.142857142857143,14.285714285714286,-1.960969557889861,57.104546918797496,59.06551647668736,55.5536734241096,60.604422604422616,71.5847665847666
2017-09-18T00:00:00Z,259.66,303.78,252.55,283.21,1086273,1701492.85,1086273,1701492.85,57.859460078272804,23956877,13623484.638133595,13623484.638133595,23956877,30.71795049683076,0,7.142857142857143,-4.271031979573657,53.72672650222029,57.997758481793944,57.859460078272804,70.3891841200375,67.19688610717058
2017-09-25T00:00:00Z,283.21,312.75,278,303.25,641119,1683131.5,641119,1683131.5,59.77196918341032,24597996,13914063.75324151,13914063.75324151,24597996,28.542697943874558,71.42857142857143,0,-4.74488830859935,52.06664809604476,56.81153640464411,59.77196918341032,64.88260445577976,65.29207039341331
2017-10-02T00:00:00Z,303.25,314.62,286.44,309.2,416663,1624517.75,416663,1624517.75,60.347381585800555,25014659,14170449.00590297,14170449.00590297,25014659,26.55240065000043,64.28571428571429,14.285714285714286,-4.931382223135806,50.64730862572435,55.578690848860155,60.347381585800555,67.11424499287375,67.46201118956368
2017-10-09T00:00:00Z,309.2,347,285.88,336.89,860299,1524934.35,860299,1524934.35,62.9998179796822,25874958,14746139.927041713,14746139.927041713,25874958,25.214095819209952,57.142857142857146,7.142857142857143,-3.529350995240307,51.16700210480977,54.696353100050075,62.9998179796822,77.49981246718175,69.83222063861177
2017-10-16T00:00:00Z,336.89,350,287.4,295.14,782890,1471389.9,782890,1471389.9,56.82747982126978,25092068,14156846.367936281,14156846.367936281,25092068,24.018261425512474,50,0,-5.6286142472936405,47.66058529093303,53.28919953822667,56.82747982126978,58.23995402865,67.61800382956852
2017-10-23T00:00:00Z,295.14,311.7,275.46,303.38,559676,1414793.95,559676,1414793.95,57.70816832441938,25651744,14459540.893322594,14459540.893322594,25651744,22.67841910196627,42.857142857142854,0,-6.609300434826004,45.027573994694166,51.63687442952017,57.70816832441938,57.27667352067626,64.33881333883603
2017-10-30T00:00:00Z,303.39,309.94,278.88,296.57,663602,1324959.4,663602,1324959.4,56.67910408569281,24988142,14551838.402659362,14551838.402659362,24988142,21.43427980153051,35.714285714285715,0,-7.7828669061387785,41.9082907968467,49.69115770298548,56.67910408569281,51.329451722464825,55.61535975726372
2017-11-06T00:00:00Z,296.58,329.47,287,307.1,1093431,1317151,1093431,1317151,57.92838560720296,26081573,14493395.069247542,14493395.069247542,26081573,20.638910105685262,28.571428571428573,0,-7.891469690370684,39.82682059002212,47.71829028039281,57.92838560720296,53.87144838925141,54.15919121079752
2017-11-13T00:00:00Z,307.11,374.7,306.5,354.59,1029251,1257798.75,1029251,1257798.75,63.097093002353816,27110824,14915659.629071588,14915659.629071588,27110824,20.650705600497396,21.428571428571427,35.714285714285715,-4.950193619503082,41.53054825601396,46.48074187551704,63.097093002353816,78.27159225196526,61.15749745456052
2017-11-20T00:00:00Z,354.24,488,350.5,473.99,1574598,1295186.25,1574598,1295186.25,72.30850191134833,28685422,16169383.185726134,16169383.185726134,28685422,22.019748450058405,100,28.571428571428573,4.3489115776139755,51.91688134753451,47.56796976992054,72.30850191134833,95.0971128608924,75.74671783403637
2017-11-27T00:00:00Z,473.99,518.13,401.5,464.76,1792470,1252214.4,1792470,1252214.4,70.83651241340267,26892952,16321381.199101767,16321381.199101767,26892952,23.56755190919552,100,21.428571428571427,8.926728292924224,58.72638013607582,49.799651843151594,70.83651241340267,83.10434342155249,85.49101617813672
2017-12-04T00:00:00Z,465,535.1,415.01,447.51,2134671,1185233.15,2134671,1185233.15,68.04843041911155,24758281,15342123.763928147,15342123.763928147,24758281,25.155853801614654,100,14.285714285714286,9.773192654406742,62.01614266116002,52.242950006753276,68.04843041911155,73.68484302238245,83.96209976827579
2017-12-11T00:00:00Z,447.51,784.77,445.23,732.18,3070910,1272334,3070910,1272334,81.19939273868073,27829191,17461751.69465796,17461751.69465796,27829191,28.074856543025806,100,7.142857142857143,27.482098565128865,86.59557321316436,59.11347464803549,81.19939273868073,90.97198379454781,82.58705674616094
2017-12-18T00:00:00Z,732.17,875,460,697.04,1493095,1273268.7,1493095,1273268.7,76.98701272313674,26336096,17674310.857549526,17674310.857549526,26336096,31.093063682917027,100,0,34.35956172150145,102.0629267999123,67.70336507841085,76.98701272313674,71.40975178729214,78.68885953474081
2017-12-25T00:00:00Z,697.05,771,676.03,741.27,372801,1213967.15,372801,1213967.15,78.49895169914959,26708897,17813703.966004826,17813703.966004826,26708897,33.89568459853031,92.85714285714286,0,39.074454002058204,116.5464325809836,77.4719785789254,78.49895169914959,77.69456583380592,80.02543380521531
2018-01-01T00:00:00Z,741.24,1118.3,727.14,1118.3,537824,1199430.35,537824,1199430.35,86.58801200877434,27246721,18351527.966004826,18351527.966004826,27246721,37.264064614922255,100,28.571428571428573,63.336186243175206,156.6422113828944,93.3060251397192,86.58801200877434,99.99999999999999,83.03477254036603
2018-01-08T00:00:00Z,1118.3,1419.96,950,1365.46,555746,1178802.9,555746,1178802.9,89.40265068179914,27802467,18778377.221601047,18778377.221601047,27802467,40.73377613495457,100,21.428571428571427,90.1453030116202,205.98765390424444,115.84235089262424,89.40265068179914,95.23809523809524,90.97755369063374
2018-01-15T00:00:00Z,1365.46,1380.97,757,1047.13,597167,1150721.9,597167,1150721.9,69.24636369823656,27205300,18736544.810475513,18736544.810475513,27205300,41.98748054152495,92.85714285714286,14.285714285714286,80.8519827574541,216.90732933944184,136.05534658198775,69.24636369823656,67.42420270860637,87.55409931556721
2018-01-22T00:00:00Z,1047.13,1224,905,1215.01,371278,1089638.35,371278,1089638.35,72.73725120825758,27576578,19086896.232293695,19086896.232293695,27576578,43.15163463334031,85.71428571428571,7.142857142857143,80.26203390356218,236.38288896144047,156.1208550578783,72.73725120825758,82.09261686325907,81.58497160332026
2018-01-29T00:00:00Z,1215.01,1221.67,726.43,826,491305,1006253.45,491305,1006253.45,56.68159871179109,27085273,18793148.937042907,18793148.937042907,27085273,42.68073255239527,78.57142857142857,0,49.43576351077883,217.91555944635184,168.479795935573,56.68159871179109,47.94755845339503,65.82145934175351
2018-02-05T00:00:00Z,826.01,908.76,555.66,811.35,584368,981158.2,584368,981158.2,56.1786727074946,26500905,19055096.73381436,19055096.73381436,26500905,41.03535536813895,71.42857142857143,0,25.05202310620757,199.79482481833247,174.7428017121249,56.1786727074946,46.28142211552041,58.77386581072486
2018-02-12T00:00:00Z,811.38,982.99,810.99,912.41,234367,960820.6,234367,960820.6,58.88855891054862,26735272,19097119.281953894,19097119.281953894,26735272,39.82204279268627,64.28571428571429,0,13.31181490210875,191.38257033976083,178.07075543765208,58.88855891054862,54.41686275214197,49.5486144403525
2018-02-19T00:00:00Z,913.4,958,786.59,841.96,203621,950168.5,203621,950168.5,56.27594801972161,26531651,19025048.305523112,19025048.305523112,26531651,38.52677654975644,57.142857142857146,0,-0.8639389910565853,176.99083169883136,177.85477068988794,56.27594801972161,45.954032876404916,48.88410591468912
2018-02-26T00:00:00Z,842.79,894,835.21,861.74,220882,918197.65,220882,918197.65,56.85471943914548,26752533,19003519.918722637,19003519.918722637,26752533,37.324029324178746,50,0,-10.062892396380107,165.2761551944128,175.33904759079292,56.85471943914548,45.189796359209,48.52023066258531
2018-03-05T00:00:00Z,861.74,866,641.6,719.8,617410,909923.65,617410,909923.65,51.57854705960282,26135123,18816425.979328696,18816425.979328696,26135123,34.911848821017074,42.857142857142854,0,-25.95791655982265,142.8916518910146,168.84956845083724,51.57854705960282,30.328872083188212,40.490900439600736
2018-03-12T00:00:00Z,719.79,739,450,538,1050137,934446.7,1050137,934446.7,45.725468172811986,25084986,18405818.778636653,18405818.778636653,25084986,33.17808529834122,35.714285714285715,0,-47.70127345526231,109.22297663175937,156.92425008702168,45.725468172811986,9.517507412309048,28.345391951568775
2018-03-19T00:00:00Z,538.01,589.75,507.84,522.55,734848,938009,734848,938009,45.25545985490148,24350138,17934909.591480017,17934909.591480017,24350138,31.56816202728507,28.571428571428573,0,-61.24564008118355,80.36719998554224,141.6128400667258,45.25545985490148,7.479689884118928,15.775356459872086
2018-03-26T00:00:00Z,522.55,525,360,378.18,1235201,945097.5,1235201,945097.5,41.01313867149227,23114937,16971901.975480016,16971901.975480016,23114937,30.770565923237363,21.428571428571427,100,-77.02880238438131,45.32683708624916,122.35563947063046,41.01313867149227,1.7151590626061366,6.2374521196780615
2018-04-02T00:00:00Z,378.69,421.59,363.33,399.9,689909.94458,928130.447229,689909.94458,928130.447229,41.895626919900046,23804846.94458,17148109.66472393,17148109.66472393,23804846.94458,30.029940969478787,14.285714285714286,92.85714285714286,-82.61277899160899,19.089665731119226,101.70244472272822,41.895626919900046,3.7642929921883823,4.31971397963784
2018-04-09T00:00:00Z,399.9,534.57,388,533.74,937187.4103300001,896259.9177455001,937187.4103300001,896259.9177455001,47.143274795459575,24742034.35491,18074682.82178827,18074682.82178827,24742034.35491,28.583000049122187,7.142857142857143,85.71428571428571,-74.16785461342447,8.99262645594763,83.1604810693721,47.143274795459575,16.391184573002754,7.290212209265782
2018-04-16T00:00:00Z,534,643.47,498.29,620.07,830246.2888500001,848148.7321880001,830246.2888500001,848148.7321880001,50.26353814187754,25572280.643760003,18637292.202536743,18637292.202536743,25572280.643760003,26.581208001758554,0,78.57142857142857,-60.235517437738906,7.866084272198464,68.10160170993737,50.26353814187754,25.472834657237726,15.20943740747631
2018-04-23T00:00:00Z,620.08,711,578.75,687.51,1031863.6451299998,793008.3644445001,1031863.6451299998,793008.3644445001,52.61672583345681,26604144.288890004,19302600.42953285,19302600.42953285,26604144.288890004,25.023982467351992,0,71.42857142857143,-44.66235910715936,12.273652825988165,56.936011933147526,52.61672583345681,37.90625,26.590089743413518
2018-04-30T00:00:00Z,688,828.97,627.2,784.33,878124.07901,683369.0683950002,878124.07901,683369.0683950002,55.84654753775465,27482268.367900003,19792168.6391172,19792168.6391172,27482268.367900003,24.195546782212222,0,64.28571428571429,-26.90037904415889,23.310538127948917,50.210917172107806,55.84654753775465,49.245070618682334,37.541385091973375
2018-05-07T00:00:00Z,784.88,789.98,637.65,729.29,897907.88305,653609.7125475002,897907.88305,653609.7125475002,53.609410719525464,26584360.484850004,19974603.149590496,19974603.149590496,26584360.484850004,23.426285074582438,0,57.142857142857146,-18.327639291105086,27.301368058226444,45.62900734933153,53.609410719525464,59.27703494438113,48.809451854354506
2018-05-14T00:00:00Z,729.29,746.06,656.5,714,612823.64891,665610.8449930002,612823.64891,665610.8449930002,52.97455176490191,25971536.835940003,20148679.005198695,20148679.005198695,25971536.835940003,22.711970631783355,7.142857142857143,50,-13.385409988796496,28.897244863335914,42.28265485213241,52.97455176490191,56.822741938072845,55.11494916704546
2018-05-21T00:00:00Z,714,717,545.36,570.75,698753.50072,673657.320029,698753.50072,673657.320029,47.32052803430111,25272783.33522,19656652.973405294,19656652.973405294,25272783.33522,21.266634589637714,0,42.857142857142854,-19.11339433416707,18.39091193442357,37.50430626859064,47.32052803430111,35.24247491638796,50.44741726628067
2018-05-28T00:00:00Z,570.75,627.83,507,618.63,661565.7168599999,678948.305872,661565.7168599999,678948.305872,49.26949170789951,25934349.05208,20217475.421290502,20217475.421290502,25934349.05208,19.824172329478014,0,35.714285714285715,-18.987958095683723,13.769358648985985,32.75731674466971,49.26949170789951,48.43258426966292,46.83260037470793
2018-06-04T00:00:00Z,618.63,626.55,505,525.25,516008.5191599999,674890.3818300001,516008.5191599999,674890.3818300001,45.71706532434191,25418340.532920003,19873398.987905737,19873398.987905737,25418340.532920003,18.49845865407513,0,28.571428571428573,-24.171892603250807,2.5424509906061985,26.714343593857006,45.71706532434191,32.65810276679842,38.77772065094979
2018-06-11T00:00:00Z,525.25,538.99,450.11,496.5,786229.6830999999,695637.9659850001,786229.6830999999,695637.9659850001,44.6496492961224,24632110.849820003,19907898.265179478,19907898.265179478,24632110.849820003,17.6500799293686,0,21.428571428571427,-28.232259176656186,-8.57598037696323,19.656278799692956,44.6496492961224,29.106339424696674,36.732342153719365
2018-06-18T00:00:00Z,496.5,547.4,421.1,454.79,609205.08418,701532.970194,609205.08418,701532.970194,43.07820148311325,24022905.76564,19623699.028759163,19623699.028759163,24022905.76564,17.062100040021154,50,14.285714285714286,-32.13827390445597,-20.516563580877005,11.621710323578963,43.07820148311325,20.212380322835152,27.32560750477678
2018-06-25T00:00:00Z,454.79,473.27,404.22,451.43,474937.3815,696061.4392690001,474937.3815,696061.4392690001,42.94707233329692,23547968.384140003,19798198.107233528,19798198.107233528,23547968.384140003,16.63533094109217,42.857142857142854,7.142857142857143,-33.22212710476766,-29.90594855738061,3.3161785473870466,42.94707233329692,19.495916583150308,22.938212110227408
2018-07-02T00:00:00Z,451.43,494.74,442.79,486.08,367961.59468999994,702741.1690035001,367961.59468999994,702741.1690035001,44.81271870153956,23915929.978830002,20043482.22704324,20043482.22704324,23915929.978830002,16.04371721262348,35.714285714285715,0,-29.9788574087349,-34.15739321353158,-4.178535804796678,44.81271870153956,26.36156687569796,22.023287927227837
2018-07-09T00:00:00Z,486.09,488,418.23,449.41,381846.14340000006,711652.4261735001,381846.14340000006,711652.4261735001,43.202615240198455,23534083.835430004,20002927.835147098,20002927.835147098,23534083.835430004,15.687037009227712,28.571428571428573,0,-28.67659637163157,-40.02428126933614,-11.347684897704571,43.202615240198455,13.926117422953947,19.927866960600767
2018-07-16T00:00:00Z,449.42,515.88,441,456.9,439927.46823,722604.6995850002,439927.46823,722604.6995850002,43.64798175086558,23974011.303660005,19749828.538521186,19749828.538521186,23974011.303660005,15.080333055795045,21.428571428571427,0,-25.7756408358098,-43.56723594246682,-17.791595106657024,43.64798175086558,12.402589758681565,17.563424685777854
2018-07-23T00:00:00Z,456.9,484.43,445.66,466.01,343005.7841,708884.4887900001,343005.7841,708884.4887900001,44.220886037889564,24317017.087760005,19766903.626561243,19766903.626561243,24317017.087760005,14.516965099036142,14.285714285714286,71.42857142857143,-21.8625949281147,-45.1198387668004,-23.2572438386857,44.220886037889564,14.547380812242487,13.62536266462603
2018-07-30T00:00:00Z,466.01,469,395,408.83,394130.71882999997,676084.1747315002,394130.71882999997,676084.1747315002,41.377429699200775,23922886.368930005,19520092.57912094,19520092.57912094,23922886.368930005,14.445951002024424,7.142857142857143,100,-21.700962373544847,-50.38344680561676,-28.68248443207191,41.377429699200775,3.1868562343019065,10.045608935075348
2018-08-06T00:00:00Z,408.96,413.17,305.14,318.15,694878.0720500001,674085.6783340002,694878.0720500001,674085.6783340002,37.28309684176092,23228008.296880003,18992582.15897079,18992582.15897079,23228008.296880003,15.091990706806316,0,100,-25.98754693234479,-61.1669180975029,-35.17937116515811,37.28309684176092,2.6833594587905267,6.805865501778336
2018-08-13T00:00:00Z,318.16,322.27,250.28,300.03,1308270.10205,677739.1334365002,1308270.10205,677739.1334365002,36.50575448780522,21919738.194830004,19492519.79624535,19492519.79624535,21919738.194830004,16.07685904352188,0,100,-28.14763739289269,-70.36391790627397,-42.21628051338128,36.50575448780522,10.034692807293553,5.301636166795358
2018-08-20T00:00:00Z,300.03,304,259.11,274.25,595410.6759,673014.1700025002,595410.6759,673014.1700025002,35.375661135083874,21324327.518930003,19298736.103331584,19298736.103331584,21324327.518930003,16.99137964190061,0,92.85714285714286,-29.28633618391408,-78.82420074327388,-49.5378645593598,35.375661135083874,5.135841618100788,5.951297961394985
2018-08-27T00:00:00Z,274.26,302.2,271.32,295.06,446087.7706,648459.1880160002,446087.7706,648459.1880160002,37.069180737190685,21770415.28953,19538537.171724074,19538537.171724074,21770415.28953,17.84057734039515,0,85.71428571428571,-26.68513955044039,-82.89428899741029,-56.209149446969896,37.069180737190685,11.860680704542442,9.010405043312291
2018-09-03T00:00:00Z,295.06,296.38,185.39,195.91,1130483.88741,663471.0679440002,1130483.88741,663471.0679440002,32.6755607986255,20639931.40212,18622355.30243378,18622355.30243378,20639931.40212,19.244407948140218,0,100,-29.47095406519074,-93.04784202845832,-63.57688796326758,32.6755607986255,2.384622359234747,6.460381560626022
2018-09-10T00:00:00Z,195.92,227.55,167,220.19,1298533.16728,676804.5440515003,1298533.16728,676804.5440515003,34.716151458007474,21938464.5694,19605208.730285842,19605208.730285842,21938464.5694,20.66921266057625,0,100,-27.54302129300588,-98.00566457952493,-70.46264328651905,34.716151458007474,13.982649842271295,9.409317635349524
2018-09-17T00:00:00Z,220.19,255,192.2,244.35,1201218.57962,692959.2690820002,1201218.57962,692959.2690820002,36.76986647947826,23139683.14902,20399007.632423263,20399007.632423263,23139683.14902,21.576377887533127,7.142857142857143,92.85714285714286,-22.706550466257056,-98.84583136934037,-76.13928090308332,36.76986647947826,20.333859095688748,12.233710432398292
2018-09-24T00:00:00Z,244.35,245.79,203.24,232.27,1034986.41301,699813.1955800002,1034986.41301,699813.1955800002,36.157394469556074,22104696.73601,20776272.950068038,20776272.950068038,22104696.73601,22.418745598278797,0,85.71428571428571,-18.561599442457236,-99.34128020615486,-80.77968076369763,36.157394469556074,18.7084384315524,17.67498245650418
2018-10-01T00:00:00Z,232.27,234.92,214,224.82,467057.16659000004,692524.8714640002,467057.16659000004,692524.8714640002,35.76176632772925,21637639.56942,20792347.575304404,20792347.575304404,21637639.56942,23.200944186828348,21.428571428571427,78.57142857142857,-14.729583392824722,-99.19166000472853,-84.46207661190381,35.76176632772925,16.573033707865164,18.538443745035465
2018-10-08T00:00:00Z,224.83,231.1,184.81,191.87,652455.59473,690209.9761645002,652455.59473,690209.9761645002,33.99031560610361,20985183.974689998,20338912.784151584,20338912.784151584,20985183.974689998,24.177755554095157,14.285714285714286,71.42857142857143,-12.88836826318024,-100.5725369408791,-87.68416867769886,33.99031560610361,7.128525567530384,14.136665902316011
2018-10-15T00:00:00Z,192.05,220.64,189.96,202.12,604066.8068600001,687335.0306645002,604066.8068600001,687335.0306645002,35.06783019760263,21589250.781549998,20213689.026275784,20213689.026275784,21589250.781549998,25.084794680842908,7.142857142857143,64.28571428571429,-9.605169846277278,-99.69063098554545,-90.08546113926818,35.06783019760263,10.066498509516167,11.256019261637269
2018-10-22T00:00:00Z,202.12,204.35,195.83,202.43,289175.31586,675993.3704995002,289175.31586,675993.3704995002,35.10233401076316,21878426.097409997,20372531.80541015,20372531.80541015,21878426.097409997,25.927045298537244,0,57.142857142857146,-6.202730380363278,-97.83887411472227,-91.636143734359,35.10233401076316,11.161515924770818,9.45218000060582
2018-10-29T00:00:00Z,202.44,217.77,190.92,210.06,401488.90096,656756.3313925002,401488.90096,656756.3313925002,36.0037171997373,22279914.998369996,20543444.957662396,20543444.957662396,22279914.998369996,26.422336151815433,0,50,-2.422631857714535,-94.66443355650216,-92.24180169878763,36.0037171997373,14.258278145695364,11.828764193327478
2018-11-05T00:00:00Z,210.06,222.78,205.38,209.88,387671.23146000004,645679.6387565002,387671.23146000004,645679.6387565002,35.991017099560494,21892243.766909994,20356293.328681707,20356293.328681707,21892243.766909994,26.771631232900635,0,42.857142857142854,0.9031227479857478,-91.11289826380545,-92.0160210117912,35.991017099560494,17.418856887516757,14.279550319327676
2018-11-12T00:00:00Z,209.72,211.22,165.2,175.87,925434.0791,668204.4736365002,925434.0791,668204.4736365002,33.58073014692354,20966809.687809993,19859993.60959896,19859993.60959896,20966809.687809993,27.54472607635801,0,100,1.608751870290149,-90.00508117392852,-91.61383304421867,33.58073014692354,6.793149551155546,12.823428194789251
2018-11-19T00:00:00Z,175.9,175.92,98.2,114.3,2647283.6798900003,782170.5778965002,2647283.6798900003,782170.5778965002,29.702648005728307,18319526.007919993,18309500.131619126,18309500.131619126,18319526.007919993,28.891452965857635,0,100,-1.1273346304644747,-93.02300133229926,-91.89566670183478,29.702648005728307,7.823129251700678,10.67837856345769
2018-11-26T00:00:00Z,114.29,126.46,99.26,114.76,1461385.75819,836147.5586360001,1461385.75819,836147.5586360001,29.767906319174244,19780911.76610999,18513664.31842508,18513664.31842508,19780911.76610999,30.141985077535853,0,92.85714285714286,-1.9160125208336893,-94.2906823528769,-92.37466983204321,29.767906319174244,8.11764705882353,7.577975287226612
2018-12-03T00:00:00Z,114.76,115.12,81.02,92.79,1790376.0844700001,903669.9894480001,1790376.0844700001,903669.9894480001,28.411326657833968,17990535.68163999,17959225.27291179,17959225.27291179,17990535.68163999,31.466459710707568,0,100,-2.8698118428717123,-95.96193463563284,-93.09212279276113,28.411326657833968,5.465267459138191,7.135347923220827
2018-12-10T00:00:00Z,92.8,94.62,80.6,83.74,896106.67726,931325.0341060001,896106.67726,931325.0341060001,27.848338186937994,17094429.00437999,17464513.027405914,17464513.027405914,17094429.00437999,32.7002008789696,0,100,-3.0460412445887926,-96.89967434849711,-93.85363310390832,27.848338186937994,1.8004587155963305,5.127791077852712
2018-12-17T00:00:00Z,83.74,133,83.51,129.61,1867102.4816900003,1004973.6222490001,1867102.4816900003,1004973.6222490001,34.89066377545895,18961531.486069992,19075827.37359666,19075827.37359666,18961531.486069992,32.84538788483548,7.142857142857143,92.85714285714286,0.7861419931752778,-92.87095561243922,-93.6570976056145,34.89066377545895,28.102064220183497,11.7892634649727
2018-12-24T00:00:00Z,129.61,159.51,112.26,138.78,2288333.21885,1084646.379589,2288333.21885,1084646.379589,36.230670238385606,21249864.704919994,19356238.999779552,19356238.999779552,21249864.704919994,32.35023004383669,0,85.71428571428571,4.585931201071659,-87.92468360427492,-92.51061480534658,36.230670238385606,35.220049639808714,21.707524191862873
2018-12-31T00:00:00Z,138.83,160.62,128.5,155.92,1372578.0854800001,1087861.7787605,1372578.0854800001,1087861.7787605,38.76739039054306,22622442.790399995,20327128.604452826,20327128.604452826,22622442.790399995,31.86397155750556,0,78.57142857142857,8.664399745272789,-81.6801151237556,-90.34451486902839,38.76739039054306,48.80767236910316,37.37659540969849
2019-01-07T00:00:00Z,155.91,157.15,113.5,115.58,1105872.40046,1113384.8649885,1105872.40046,1113384.8649885,35.216653067173254,21516570.389939994,19326649.770680424,19326649.770680424,21516570.389939994,31.630876989489614,0,71.42857142857143,9.015751802230398,-79.07482511624039,-88.09057691847079,35.216653067173254,23.242524916943523,35.756748975285156
2019-01-14T00:00:00Z,115.61,132.38,115.34,117.43,926039.9425499999,1137382.473586,926039.9425499999,1137382.473586,35.50837950242034,22442610.332489993,18627772.20840384,18627772.20840384,22442610.332489993,31.41443203347481,0,64.28571428571429,9.684519510232505,-75.98492753068015,-85.66944704091266,35.50837950242034,25.903783935855966,32.65132707396758
2019-01-21T00:00:00Z,117.44,119.5,110.3,111.35,521844.41857000004,1106950.5001440002,521844.41857000004,1106950.5001440002,34.95133144694225,21920765.913919993,18225044.450594384,18225044.450594384,21920765.913919993,31.293784147120405,21.428571428571427,57.142857142857146,9.989032237591786,-73.18315674392292,-83.17218898151471,34.95133144694225,21.627514418342944,23.59127442371417
2019-01-28T00:00:00Z,111.35,112.1,100.9,105.94,663542.6464799999,1075200.9741040003,663542.6464799999,1075200.9741040003,34.43369622155544,21257223.26743999,18158690.185946383,18158690.185946383,21257223.26743999,31.33570139969927,14.285714285714286,50,10.069264749239082,-70.58560804496585,-80.65487279420493,34.43369622155544,17.822478548319033,21.784592300839346
2019-02-04T00:00:00Z,105.98,125.28,100.15,123.94,634942.09928,1046887.1500870002,634942.09928,1046887.1500870002,37.737733563742694,21892165.36671999,18725918.60332943,18725918.60332943,21892165.36671999,30.957691127362047,7.142857142857143,42.857142857142854,11.475738464674563,-66.31019971336173,-77.78593817803629,37.737733563742694,30.48248698832466,23.31082665166224
2019-02-11T00:00:00Z,123.93,134.14,117,132.34,685020.1625300001,1029388.8375630003,685020.1625300001,1029388.8375630003,39.2756011176416,22577185.529249992,19267060.55202583,19267060.55202583,22577185.529249992,30.32716210209664,0,35.714285714285715,13.000939694918188,-61.53476355938855,-74.53570325430674,39.2756011176416,39.61108559179299,29.305350376145594
2019-02-18T00:00:00Z,132.33,165.62,131,131.76,1357323.6561899998,1073902.162043,1357323.6561899998,1073902.162043,39.203597664796334,21219861.87305999,17969330.53989732,17969330.53989732,21219861.87305999,28.815376050263914,0,28.571428571428573,13.917889070077408,-57.138341916709976,-71.05623098678738,39.203597664796334,53.671842215694504,41.255138265270745
2019-02-25T00:00:00Z,131.88,141.09,125.7,129.78,748062.81479,1078682.5230460002,748062.81479,1078682.5230460002,38.941138941490216,20471799.058269992,17617901.420278624,17617901.420278624,20471799.058269992,27.534131359826358,0,21.428571428571427,14.284463550998552,-53.20065154803919,-67.48511509903774,38.941138941490216,57.84521289108446,50.37604689952402
2019-03-04T00:00:00Z,129.79,140,122.75,134.66,703992.58721,1083678.8120635,703992.58721,1083678.8120635,40.0071793931916,21175791.645479992,17886030.770885564,17886030.770885564,21175791.645479992,26.41567246752363,85.71428571428571,14.285714285714286,14.692089262625913,-49.12000352075535,-63.81209278338126,40.0071793931916,63.585038814396604,58.367364640391884
2019-03-11T00:00:00Z,134.67,147.23,127.19,138.07,556423.93805,1097041.2431730002,556423.93805,1097041.2431730002,40.78517063516988,21732215.583529994,17933787.7156683,17933787.7156683,21732215.583529994,25.14775221900742,78.57142857142857,7.142857142857143,14.976778467846756,-45.09111969857281,-60.06789816641957,40.78517063516988,67.59585979769466,63.00870383439193
2019-03-18T00:00:00Z,138.08,141.3,132.21,135.37,393074.69895,1096620.5330725003,393074.69895,1096620.5330725003,40.33910806050816,21339140.884579994,17814005.876714338,17814005.876714338,21339140.884579994,23.970397702528086,71.42857142857143,0,14.745428540418686,-41.63611249089621,-56.381541031314896,40.33910806050816,63.15917671416393,64.78002510875176
2019-03-25T00:00:00Z,135.36,145.48,130.64,141.2,403875.90658999997,1097430.7668290003,403875.90658999997,1097430.7668290003,41.81878120585166,21743016.791169994,17984918.32236024,17984918.32236024,21743016.791169994,22.730590789552892,64.28571428571429,0,14.713519885496545,-37.989641174444216,-52.70316105994076,41.81878120585166,62.700473499312636,64.48517000372377
2019-04-01T00:00:00Z,141.23,180.1,138.81,174.84,1506880.6481399997,1126503.095281,1506880.6481399997,1126503.095281,49.58807349178546,23249897.439309992,19107871.035929333,19107871.035929333,23249897.439309992,21.732219286293212,100,42.857142857142854,16.549524003490305,-32.016256055577884,-48.56578005906819,49.58807349178546,93.42088805503441,73.09351275617036
2019-04-08T00:00:00Z,174.91,187.62,159.27,168.27,1001149.2040799999,1044196.3714905002,1001149.2040799999,1044196.3714905002,48.23338193116112,22248748.23522999,18742372.120154094,18742372.120154094,22248748.23522999,21.01774225021949,100,35.714285714285715,16.856225315408878,-27.495498414807088,-44.351723730215966,48.23338193116112,77.87812964444953,77.99983039959888
2019-04-15T00:00:00Z,168.32,177.84,156,169.9,601639.1151400001,1001209.0393380001,601639.1151400001,1001209.0393380001,48.60849435550464,22850387.35036999,18906555.68820512,18906555.68820512,22850387.35036999,20.23423619264979,92.85714285714286,28.571428571428573,16.673197562574856,-23.5102267769974,-40.183424339572255,48.60849435550464,79.74162570024008,83.6802144665747
2019-04-22T00:00:00Z,169.89,176.94,146,153.19,753701.99875,949375.3350520001,753701.99875,949375.3350520001,45.00790201072874,22096685.35161999,18503152.16204804,18503152.16204804,22096685.35161999,19.135619744506098,85.71428571428571,21.428571428571427,14.984394192522892,-21.45293159891864,-36.43732579144153,45.00790201072874,60.63793300560191,72.75256278343052
2019-04-29T00:00:00Z,153.17,169.26,148.81,161.25,609530.02829,935046.5026035002,609530.02829,935046.5026035002,47.04545223910074,22706215.37990999,18635192.163286414,18635192.163286414,22706215.37990999,18.115475899801243,78.57142857142857,14.285714285714286,13.986940767960974,-18.95364983149031,-32.94059059945128,47.04545223910074,69.85252086429632,70.07735985671279
2019-05-06T00:00:00Z,161.26,207,157.78,188.23,1554588.0211600002,919420.7795770001,1554588.0211600002,919420.7795770001,53.285036267838635,24260803.401069988,19004098.86964864,19004098.86964864,24260803.401069988,18.33197565304664,100,7.142857142857143,14.650651384439982,-14.627276368901306,-29.277927753341288,53.285036267838635,82.43331773514271,70.97459053501366
2019-05-13T00:00:00Z,188.23,281.77,185.62,261.09,3181750.9344900004,964091.6653590001,3181750.9344900004,964091.6653590001,65.20757984550308,27442554.335559987,20817183.98354055,20817183.98354055,27442554.335559987,20.040182957652213,100,0,19.215317250429667,-5.258781190304205,-24.474098440733872,65.20757984550308,87.44917157249499,79.91167005731137
2019-05-20T00:00:00Z,260.44,271.19,231.12,268.37,1288733.4735700001,959899.4347635001,1288733.4735700001,959899.4347635001,66.13752741706797,28731287.809129987,21924523.476802718,21924523.476802718,28731287.809129987,21.626375454785958,92.85714285714286,0,21.756780977267763,2.721877780850832,-19.03490319641693,66.13752741706797,91.57338699534651,87.15195876766143
2019-05-27T00:00:00Z,268.23,288.77,235.44,269.23,1264213.93678,967816.5115795002,1264213.93678,967816.5115795002,66.25228198769113,29995501.74590999,22262326.750740748,22262326.750740748,29995501.74590999,23.379806246245156,100,14.285714285714286,22.4376155645931,9.012116259324443,-13.425499305268655,66.25228198769113,88.23033369473559,89.08429742085906
2019-06-03T00:00:00Z,269.24,270.3,226.56,231.3,963467.45347,969687.8871255001,963467.45347,969687.8871255001,57.06676408899925,29032034.29243999,21507676.660299912,21507676.660299912,29032034.29243999,24.635523063088513,92.85714285714286,7.142857142857143,19.389926335533048,10.811908614147654,-8.578017721385393,57.06676408899925,65.38368871220337,81.72913646742852
2019-06-10T00:00:00Z,231.36,278.83,227.52,268.33,891654.44571,988178.3884825001,891654.44571,988178.3884825001,62.528815467214976,29923688.73814999,22034397.49930732,22034397.49930732,29923688.73814999,25.951634738132253,85.71428571428571,0,18.904614032802023,15.052749819617134,-3.8518642131848875,62.528815467214976,87.34991954449808,80.32131398381237
2019-06-17T00:00:00Z,268.35,318,261,306.98,1127367.70972,1011369.6416445,1127367.70972,1011369.6416445,67.21687367123411,31051056.44786999,22725849.694602255,22725849.694602255,31051056.44786999,27.782421662299463,100,0,20.111087994847075,21.286995780373957,1.1759077855268822,67.21687367123411,94.11827497865073,82.28396107845076
2019-06-24T00:00:00Z,306.85,364.49,273.5,290.07,1911439.55733,1075194.5145470002,1911439.55733,1075194.5145470002,63.4750980107093,29139616.89053999,21510586.71634596,21510586.71634596,29139616.89053999,30.037772959264274,100,7.142857142857143,18.723148814308722,24.579843803412786,5.856694989104064,63.4750980107093,68.17618131280734,83.21479194531874
2019-07-01T00:00:00Z,290.08,310.7,270.42,306.34,910261.88723,1086456.600782,910261.88723,1086456.600782,65.46697575352324,30049878.77776999,22223790.915973037,22223790.915973037,30049878.77776999,32.003097554652946,92.85714285714286,0,17.856636045457293,28.17749004592568,10.320854000468387,65.46697575352324,74.2334278624601,78.84262805130608
2019-07-08T00:00:00Z,306.33,318.6,222.7,225.76,1048713.51486,1071026.0937155,1048713.51486,1071026.0937155,50.715414355242075,29001165.26290999,21242002.6014357,21242002.6014357,29001165.26290999,32.03923871985267,85.71428571428571,0,11.140927654616188,24.247013568738623,13.106085914122435,50.715414355242075,36.50510320838482,59.63823746121744
2019-07-15T00:00:00Z,225.96,236.58,190.11,225.64,1611824.18878,1114214.1624150001,1611824.18878,1114214.1624150001,50.69709385014286,27389341.07412999,22094913.22769135,22094913.22769135,27389341.07412999,31.082113344181657,78.57142857142857,14.285714285714286,6.220482099758154,20.88168853882013,14.661206439061974,50.69709385014286,36.450180786306,49.062903952383664
2019-07-22T00:00:00Z,225.7,228.28,197,211.5,786398.8839899999,1118334.477254,786398.8839899999,1118334.477254,48.47497195685029,26602942.19013999,22037592.592924815,22037592.592924815,26602942.19013999,30.193354066772855,71.42857142857143,7.142857142857143,1.774309013406807,16.879092705820483,15.104783692413676,48.47497195685029,29.97848871801913,34.311257570903344
2019-07-29T00:00:00Z,211.5,224.81,204,222.81,469538.04394,1113990.1825485001,469538.04394,1113990.1825485001,50.34955979781673,27072480.23407999,22416878.24975477,22416878.24975477,27072480.23407999,29.368077594893254,64.28571428571429,0,-0.5214080027176919,14.453023689016561,14.974431691734253,50.34955979781673,34.310089020771514,33.57958617503225
2019-08-05T00:00:00Z,222.87,239.45,200.38,216.06,650182.4353199999,1126845.5693670004,650182.4353199999,1126845.5693670004,49.199102274231024,26422297.79875999,22288572.47610959,22288572.47610959,26422297.79875999,28.92410187903618,57.142857142857146,0,-2.5002741500423102,11.849089004181366,14.349363154223676,49.199102274231024,28.19408833631658,30.827555358369107
2019-08-12T00:00:00Z,216.21,216.47,171,194.74,676969.1580399999,1140500.2319395002,676969.1580399999,1140500.2319395002,45.65102132423723,25745328.64071999,22318497.8776416,22318497.8776416,25745328.64071999,27.570199019272373,50,0,-5.100933609142448,7.973196142795615,13.074129751938063,45.65102132423723,12.269367925991011,24.924515094359734
2019-08-19T00:00:00Z,194.74,203.91,180,186.59,482617.92604,1089287.0958345004,482617.92604,1089287.0958345004,44.33477861878012,25262710.71467999,22101915.261731554,22101915.261731554,25262710.71467999,26.31300350663456,42.857142857142854,92.85714285714286,-7.102885511706578,4.195522862304841,11.29840837401142,44.33477861878012,8.057263941288957,16.173573401198883
2019-08-26T00:00:00Z,186.6,194.28,163.57,171.29,463302.48442,1062394.7598515004,463302.48442,1062394.7598515004,41.89279194566312,24799408.23025999,21871546.361142386,21871546.361142386,24799408.23025999,24.635668786864805,35.714285714285715,100,-9.064740873374811,-0.03251771770709411,9.032223155667717,41.89279194566312,3.8423253036034235,8.05631905696116
2019-09-02T00:00:00Z,171.31,184.73,164.99,181.56,464237.89567000006,1055524.6988780005,464237.89567000006,1055524.6988780005,44.117821429676724,25263646.12592999,22186682.521323644,22186682.521323644,25263646.12592999,23.07814368993575,28.571428571428573,92.85714285714286,-9.246142758260984,-2.5254552921585116,6.720687466102471,44.117821429676724,8.953812462671713,6.951133902521396
2019-09-09T00:00:00Z,181.56,190.99,173.7,189.3,385166.76858000003,1037097.9373695005,385166.76858000003,1037097.9373695005,45.80221095494543,25648812.89450999,22496553.530632365,22496553.530632365,25648812.89450999,21.825423354905542,21.428571428571427,85.71428571428571,-8.442466370268058,-3.8323954967326017,4.610070873535456,45.80221095494543,12.80609197690624,8.53407658106049
2019-09-16T00:00:00Z,189.31,224.71,188.23,211.1,793752.0110400001,1046309.0365070004,793752.0110400001,1046309.0365070004,50.34222001450891,26442564.90554999,22698037.730803154,22698037.730803154,26442564.90554999,21.60167896180106,14.285714285714286,78.57142857142857,-6.146973607373303,-3.073646135681173,3.0733274716921297,50.34222001450891,23.65618156480191,15.138695334793319
2019-09-23T00:00:00Z,211.17,211.6,152.11,169.38,1126895.43504,1024924.4072010005,1126895.43504,1024924.4072010005,42.93057887400594,25315669.470509987,22225419.793263264,22225419.793263264,25315669.470509987,20.22057513151215,7.142857142857143,100,-7.076460575170749,-5.772248247271307,1.3042123278994424,42.93057887400594,8.131650814577636,14.864641452095293
2019-09-30T00:00:00Z,169.39,185.89,165.2,170.18,511261.9404,891399.9574965006,511261.9404,891399.9574965006,43.103559509327916,25826931.410909988,21960275.249015223,21960275.249015223,25826931.410909988,18.938121574815305,0,92.85714285714286,-7.248921366571238,-7.756939380314606,-0.5080180137433672,43.103559509327916,10.853504714997893,14.213779031459177
2019-10-07T00:00:00Z,170.18,197.93,168.61,181.18,622331.3194899999,858079.8497925006,622331.3194899999,858079.8497925006,45.54754631150956,26449262.73039999,21871552.707559966,21871552.707559966,26449262.73039999,18.101804584752205,7.142857142857143,85.71428571428571,-6.27039020793652,-8.346005773664018,-2.0756155657274977,45.54754631150956,17.46050813862694,12.148554556067518
2019-10-14T00:00:00Z,181.12,188.58,168.34,175.49,502431.46127,819990.7260170006,502431.46127,819990.7260170006,44.48312559403143,25946831.269129988,21724099.99610029,21724099.99610029,25946831.269129988,17.31584207094156,0,78.57142857142857,-5.672561135184383,-9.166316984707976,-3.4937558495235934,44.48312559403143,26.768948935195787,18.360987262940238
2019-10-21T00:00:00Z,175.49,199.5,153,184.41,857456.16711,814690.1616990006,857456.16711,814690.1616990006,46.590324553067525,26804287.436239988,22025039.450879544,22025039.450879544,26804287.436239988,16.105358839317127,21.428571428571427,71.42857142857143,-4.39938295965352,-8.992984549090494,-4.5936015894369735,46.590324553067525,36.981909777879544,27.07045561723412
2019-10-28T00:00:00Z,184.32,193.41,177.39,181.73,403547.34010000003,790284.8064185006,403547.34010000003,790284.8064185006,46.02508858251219,26400740.096139986,21840143.22888616,21840143.22888616,26400740.096139986,14.981338695665869,14.285714285714286,64.28571428571429,-3.4999089705919557,-8.968487802676918,-5.468578832084963,46.02508858251219,33.913441722005935,32.55476681169379
2019-11-04T00:00:00Z,181.73,194.6,180.45,188.88,363833.52463,752108.0971640006,363833.52463,752108.0971640006,47.84312083848349,26764573.620769985,21909824.419822365,21909824.419822365,26764573.620769985,13.92957288810384,7.142857142857143,57.142857142857146,-2.2465128027426395,-8.276719835513262,-6.0302070327706225,47.84312083848349,42.099839706892595,37.665063735592724
2019-11-11T00:00:00Z,188.89,190,177,183.88,356843.52953,674378.2957740007,356843.52953,674378.2957740007,46.659537822319436,26407730.091239985,21930686.041548733,21930686.041548733,26407730.091239985,13.052993691641326,0,50,-1.6072545263831417,-8.03927519074955,-6.432020664366408,46.659537822319436,43.760330578512374,39.92453733580367
2019-11-18T00:00:00Z,183.88,183.95,137.8,139.99,751484.5081800001,666439.4268215008,751484.5081800001,666439.4268215008,37.81585088944748,25656245.583059985,21250523.35668029,21250523.35668029,25656245.583059985,13.569276733728358,35.714285714285715,100,-3.8646426454415153,-11.262823971168302,-7.398181325726787,37.81585088944748,2.5198481187435253,29.460006134716195
2019-11-25T00:00:00Z,140.1,157.73,131.8,150.97,669694.87401,647488.4947790008,669694.87401,647488.4947790008,40.83694968186281,26325940.457069986,21571036.792332586,21571036.792332586,26325940.457069986,14.221049453429318,28.571428571428573,100,-4.308773076422684,-12.784147671255141,-8.475374594832457,40.83694968186281,20.632870519857914,22.30434973903797
2019-12-02T00:00:00Z,150.94,153,143.17,150.68,333031.55476,583548.8630780007,333031.55476,583548.8630780007,40.78059640881421,25992908.902309984,21746869.322261825,21746869.322261825,25992908.902309984,14.826266978865926,21.428571428571427,92.85714285714286,-4.302511171881999,-13.853513559684956,-9.551002387802956,40.78059640881421,20.320740501560646,14.491153046720726
2019-12-09T00:00:00Z,150.69,151.47,139.1,142.38,307842.84937999997,559621.0613475007,307842.84937999997,559621.0613475007,39.11682291113272,25685066.052929983,21602280.239408325,21602280.239408325,25685066.052929983,15.51669348744662,14.285714285714286,85.71428571428571,-4.515653530279289,-15.195569300652068,-10.679915770372778,39.11682291113272,11.387364115810984,17.446991712409876
2019-12-16T00:00:00Z,142.38,142.53,116.25,132.4,710945.2552899999,571691.4219150007,710945.2552899999,571691.4219150007,37.1539904719755,24974120.79763998,21765137.561967146,21765137.561967146,24974120.79763998,16.822779292383334,7.142857142857143,100,-4.952062542886354,-16.86999394898072,-11.917931406094366,37.1539904719755,14.890282131661445,15.532795583011051
2019-12-23T00:00:00Z,132.4,137.85,122.15,134.3,345936.65869999997,556479.1330840008,345936.65869999997,556479.1330840008,37.79396095619957,25320057.45633998,21954631.52787925,21954631.52787925,25320057.45633998,18.03557325411028,0,92.85714285714286,-4.73609288899727,-17.838047517340954,-13.101954628343684,37.79396095619957,18.93025694808601,15.069301065186174
2019-12-30T00:00:00Z,134.31,138.97,125.52,135.31,415840.71460999997,543422.7109125007,415840.71460999997,543422.7109125007,38.15449215605928,25735898.17094998,22144155.95766061,22144155.95766061,25735898.17094998,19.095220304708043,0,85.71428571428571,-4.168549618843878,-18.31264165189853,-14.144092033054653,38.15449215605928,22.894894894894897,18.905144658214144
2020-01-06T00:00:00Z,135.31,148,134.78,146.6,576845.11641,548134.0704310008,576845.11641,548134.0704310008,42.18802296306167,26312743.28735998,22598825.103877872,22598825.103877872,26312743.28735998,19.538320991944804,21.428571428571427,78.57142857142857,-2.744851821333187,-17.575156809721136,-14.83030498838795,42.18802296306167,36.45645645645645,26.093869433145812
2020-01-13T00:00:00Z,146.55,179.32,142.1,166.75,917368.48997,570837.3707085007,917368.48997,570837.3707085007,48.62780452858158,27230111.777329978,22896563.18444847,22896563.18444847,27230111.777329978,18.379022214812906,14.285714285714286,71.42857142857143,-0.287484969687263,-15.189661200497028,-14.902176230809765,48.62780452858158,60.66066066066066,40.00400400400403
2020-01-20T00:00:00Z,166.67,171.05,154.48,167.35,416470.7934,568449.0155950008,416470.7934,568449.0155950008,48.81065402940573,27646582.57072998,23127042.19322807,23127042.19322807,27646582.57072998,17.30253049319043,7.142857142857143,64.28571428571429,1.4419662973866423,-13.099718359076462,-14.541684656463104,48.81065402940573,61.381381381381374,52.83283283283286
2020-01-27T00:00:00Z,167.58,193.52,164.89,188.29,646998.94592,581540.6244620008,646998.94592,581540.6244620008,54.850534896329144,28293581.51664998,23537659.40759644,23537659.40759644,28293581.51664998,16.7706046663369,0,57.142857142857146,3.9192782340961223,-9.64258686384295,-13.561865097939073,54.850534896329144,91.94639438417357,71.32947880873856
2020-02-03T00:00:00Z,188.22,230.9,184.29,228.8,894869.59792,586596.5038060008,894869.59792,586596.5038060008,63.759268888081316,29188451.11456998,24351892.826343216,24351892.826343216,29188451.11456998,17.47335531878211,100,50,7.975448817805873,-3.5925540756817327,-11.568002893487606,63.759268888081316,98.16833842128217,83.83203806227907
2020-02-10T00:00:00Z,228.8,290,216.31,258.5,1530613.62463,606782.4132855007,1530613.62463,606782.4132855007,68.6442166755242,30719064.73919998,24573934.61827285,24573934.61827285,30719064.73919998,19.38602823150677,100,42.857142857142854,12.100539642386142,3.557671659495071,-8.542867982891071,68.6442166755242,81.87050359712231,90.66174546752605
2020-02-17T00:00:00Z,258.58,287.13,242.36,275.48,1164809.6409399998,639459.7983125007,1164809.6409399998,639459.7983125007,71.04704013771612,31883874.38013998,25132533.300224643,25132533.300224643,31883874.38013998,21.16208165046538,92.85714285714286,35.714285714285715,15.213244000030048,10.473687017146489,-4.739556982883559,71.04704013771612,91.6431654676259,90.56066916201014
2020-02-24T00:00:00Z,275.48,278.13,209.26,217.26,1593640.2184199998,688025.2432590006,1593640.2184199998,688025.2432590006,55.377485872112565,30290234.16171998,23909130.39115153,23909130.39115153,30290234.16171998,21.419759141339068,85.71428571428571,28.571428571428573,12.694468647968325,11.128528827076849,-1.5659398208914768,55.377485872112565,58.13525179856115,77.21630695443649
2020-03-02T00:00:00Z,217.34,253.01,196,199.46,1211203.69259,723463.8548250005,1211203.69259,723463.8548250005,51.628348363847614,29079030.46912998,22844945.283945195,22844945.283945195,29079030.46912998,21.168366515757416,78.57142857142857,21.428571428571427,9.328605989423195,10.094817665887518,0.7662116764643221,51.628348363847614,47.89064748201439,65.88968824940052
2020-03-09T00:00:00Z,199.51,208.65,90,123.3,4223419.39685,891762.0163120006,4223419.39685,891762.0163120006,39.35227240944311,24855611.07227998,20992193.664846648,20992193.664846648,24855611.07227998,21.085753001947438,71.42857142857143,100,1.862588859935989,3.0944477513843083,1.2318588914483193,39.35227240944311,16.65,40.891966426858545
2020-03-16T00:00:00Z,123.33,154,100.5,122.42,3250911.9158,1034130.2450970005,3250911.9158,1034130.2450970005,39.236181426284446,21604699.156479977,20405206.57874145,20405206.57874145,21604699.156479977,21.009040453409604,64.28571428571429,92.85714285714286,-2.9819961883906165,-2.4956363440399514,0.48635984435066504,39.236181426284446,16.21,26.916882494004824
2020-03-23T00:00:00Z,122.31,144.16,119.2,124.35,1556932.98679,1093785.2182050007,1556932.98679,1093785.2182050007,39.656634490384945,23161632.14326998,19490757.957493797,19490757.957493797,23161632.14326998,20.93780737262447,57.142857142857146,85.71428571428571,-5.743433032457237,-6.692931446220882,-0.9494984137636445,39.656634490384945,17.174999999999997,16.67833333333336
2020-03-30T00:00:00Z,124.43,150.5,124.05,142.79,824985.8231800001,1117192.3328875008,824985.8231800001,1117192.3328875008,43.667342058654285,23986617.96644998,19834787.962396458,19834787.962396458,23986617.96644998,20.670574169550747,50,78.57142857142857,-5.987713781669212,-8.43414064085016,-2.4464268591809475,43.667342058654285,26.394999999999996,19.92666666666669
2020-04-06T00:00:00Z,142.79,176.82,142.79,158.87,1777965.3394000004,1168516.3744485008,1777965.3394000004,1168516.3744485008,46.976874226137106,25764583.30584998,19737086.076276034,19737086.076276034,25764583.30584998,19.62783433674642,42.857142857142854,71.42857142857143,-4.778446731226312,-8.419485273213837,-3.6410385419875255,46.976874226137106,34.435,26.001666666666694
2020-04-13T00:00:00Z,158.82,191.22,148.08,180.39,1602837.39255,1215173.5003755006,1602837.39255,1215173.5003755006,51.11604728739105,27367420.69839998,20535160.88369314,20535160.88369314,27367420.69839998,18.258284400206424,35.714285714285715,64.28571428571429,-2.3634567190144606,-6.595359440755601,-4.2319027217411405,51.11604728739105,45.19499999999999,35.34166666666669
2020-04-20T00:00:00Z,180.28,200,166.4,197.83,1307335.84577,1263888.7149260007,1307335.84577,1263888.7149260007,54.23407116386932,28674756.54416998,21673632.51605118,21673632.51605118,28674756.54416998,17.162837697866003,28.571428571428573,57.142857142857146,0.42567004744151227,-3.6998151624392506,-4.125485209880763,54.23407116386932,53.915000000000006,44.51500000000002
2020-04-27T00:00:00Z,197.8,227.5,189.6,210.24,1443120.0197599998,1320652.5734450007,1443120.0197599998,1320652.5734450007,56.36682120558038,30117876.563929982,21802332.92942292,21802332.92942292,30117876.563929982,16.851684672127668,21.428571428571427,50,2.9811148121680375,-0.3990916946707159,-3.3802065068387535,56.36682120558038,60.12,53.07666666666669
2020-05-04T00:00:00Z,210.24,217,180.01,187.73,1524016.3245,1361306.1269055004,1524016.3245,1361306.1269055004,51.66384481837823,28593860.23942998,20914456.427855603,20914456.427855603,28593860.23942998,16.265986064552713,14.285714285714286,42.857142857142854,3.020824203956721,0.3958237481071478,-2.625000455849573,51.66384481837823,48.86499999999999,54.30000000000002
2020-05-11T00:00:00Z,187.65,210,176.43,207.05,1045259.84804,1396272.2863725005,1045259.84804,1396272.2863725005,55.1246223425987,29639120.08746998,21776009.600190032,21776009.600190032,29639120.08746998,15.608885817233018,7.142857142857143,35.714285714285715,4.144245578029154,2.555306516686869,-1.5889390613422847,55.1246223425987,58.525000000000006,55.836666666666694
2020-05-18T00:00:00Z,207.05,216.99,191.27,199.63,848663.64838,1417913.4330610004,848663.64838,1417913.4330610004,53.539164723658395,28790456.43908998,21479043.31576468,21479043.31576468,28790456.43908998,15.196317587454109,0,28.571428571428573,4.172095118361049,3.626179836609026,-0.5459152817520225,53.539164723658395,55.61304722771775,54.33434907590594
2020-05-25T00:00:00Z,199.63,247.36,196.65,231.54,837497.2690699999,1430946.0406940007,837497.2690699999,1430946.0406940007,59.00045909439347,29627953.70815998,21793992.495831035,21793992.495831035,29627953.70815998,15.600584847526955,0,21.428571428571427,6.012241208380368,6.969386228723437,0.9571450203430694,59.00045909439347,75.23520969542338,63.124418974380404
2020-06-01T00:00:00Z,231.43,253.6,225.6,244.81,1064481.50915,1438301.6916530007,1064481.50915,1438301.6916530007,61.05084413526992,30692435.217309978,22190131.686021857,22190131.686021857,30692435.217309978,16.12487051954516,0,14.285714285714286,7.688571799562573,10.567859769796286,2.8792879702337126,61.05084413526992,94.62713936430318,75.15846542914812
2020-06-08T00:00:00Z,244.79,250.56,225.2,231.34,874671.77217,1461211.7405915004,874671.77217,1461211.7405915004,57.88628327228306,29817763.445139978,21738999.715202317,21738999.715202317,29817763.445139978,16.59576943478794,92.85714285714286,7.142857142857143,7.450341849258807,12.192215281807222,4.741873432548415,57.88628327228306,86.39364303178485,85.41866403050382
2020-06-15T00:00:00Z,231.34,237,217.79,227.68,635361.84059,1460629.8853250004,635361.84059,1460629.8853250004,57.021399350551874,29182401.604549978,21757852.200841896,21757852.200841896,29182401.604549978,16.726741246795207,85.71428571428571,0,6.633661296331901,13.033950052963291,6.40028875663139,57.021399350551874,83.06988896146309,88.0302237858504
2020-06-22T00:00:00Z,227.66,249.04,215.16,224.76,783195.66415,1455046.1886365004,783195.66415,1455046.1886365004,56.2986847041811,28399205.94039998,21418498.23538375,21418498.23538375,28399205.94039998,17.184081036432826,78.57142857142857,0,5.529336471495327,13.311959346000549,7.782622874505222,56.2986847041811,78.54166666666667,82.6683995533049
2020-06-29T00:00:00Z,224.94,232.77,220.98,227.67,483493.3179000001,1402690.1733000004,483493.3179000001,1402690.1733000004,56.885161148122656,28882699.258299977,21483702.168841,21483702.168841,28882699.258299977,17.60875369823919,71.42857142857143,0,4.662066825518172,13.610206406402938,8.948139580884765,56.885161148122656,79.98456194519488,80.53203919110824
2020-07-06T00:00:00Z,227.62,249,227.08,242.81,639827.53354,1376441.0679300004,639827.53354,1376441.0679300004,59.900348048161355,29522526.791839976,21762167.25414992,21762167.25414992,29522526.791839976,18.456835123934418,64.28571428571429,0,4.758706716220903,14.896522976160895,10.137816259939992,59.900348048161355,90.26261167764643,82.92961342983602
2020-07-13T00:00:00Z,242.81,245.37,229.77,239.17,627637.1052700001,1328140.9122725003,627637.1052700001,1328140.9122725003,58.83501950294063,28894889.686569978,21890913.327025816,21890913.327025816,28894889.686569978,19.244339304937128,57.142857142857146,0,4.245098626033794,15.444189542482235,11.19909091644844,58.83501950294063,86.32486732373009,85.52401364885715
2020-07-20T00:00:00Z,239.26,319.86,233.85,311.35,1333462.9123699998,1334253.8732615004,1333462.9123699998,1334253.8732615004,70.16596953678385,30228352.598939978,22960505.308474556,22960505.308474556,30228352.598939978,21.514368643929867,100,0,8.20490294086909,21.455219592534803,13.250316651665713,70.16596953678385,94.45458099830576,90.34735333322745
2020-07-27T00:00:00Z,311.43,415,306.29,372.21,2043901.4017700003,1225277.9735075003,2043901.4017700003,1225277.9735075003,76.13165630793021,32272254.000709977,23395381.94744926,23395381.94744926,32272254.000709977,24.657282386308147,100,0,14.019859413423045,30.77514091844452,16.755281505021475,76.13165630793021,82.06396445487697,87.61447092563763
2020-08-03T00:00:00Z,372.19,408,362.88,390.41,1365038.8243999998,1130984.3189375002,1365038.8243999998,1130984.3189375002,77.575734995858,33637292.82510997,23696101.936689865,23696101.936689865,33637292.82510997,27.57570228994512,92.85714285714286,14.285714285714286,17.938344057123377,39.178211576425696,21.23986751930232,77.575734995858,89.69275265121348,88.73709936813209
2020-08-10T00:00:00Z,390.41,445.45,364.77,433.7,1676320.07116,1136953.6731560002,1676320.07116,1136953.6731560002,80.58467855950305,35313612.89626998,24884153.27120807,24884153.27120807,35313612.89626998,30.578779427107573,100,7.142857142857143,22.023043529776466,48.7686719315229,26.745628401746437,80.58467855950305,95.63229499665454,89.12967070091503
2020-08-17T00:00:00Z,433.71,447.5,379.53,390.9,1173764.5627100002,1154392.6101325,1173764.5627100002,1154392.6101325,70.51088884671042,34139848.333559975,24103082.63458348,24103082.63458348,34139848.333559975,33.38246810267638,100,0,20.45353889202775,52.312552016781126,31.859013124753375,70.51088884671042,77.91047106115597,87.74517290300803
2020-08-24T00:00:00Z,390.78,429.9,369.36,428.94,980504.6980799999,1114519.5780665001,980504.6980799999,1114519.5780665001,73.66226503152879,35120353.03163998,25052491.048878983,25052491.048878983,35120353.03163998,35.55062259005323,92.85714285714286,0,20.534766875169566,57.52747171871533,36.992704843545766,73.66226503152879,92.60115606936417,88.71464070905824
2020-08-31T00:00:00Z,428.92,488.95,310,352.77,2390907.59155,1153923.0880165002,2390907.59155,1153923.0880165002,59.86637668348681,32729445.44008998,23804462.671529524,23804462.671529524,32729445.44008998,35.41152948630816,100,0,14.310965707901005,54.88141197842202,40.57044627052102,59.86637668348681,50.26114905584572,73.59092539545532
2020-09-07T00:00:00Z,352.85,390.41,323.17,366.58,1215079.81034,1149310.286245,1215079.81034,1149310.286245,61.2822019510233,33944525.25042998,24158288.707913477,24158288.707913477,33944525.25042998,35.282371604259176,92.85714285714286,21.428571428571427,10.17125216405448,53.28451147558911,43.113259311534634,61.2822019510233,55.30516088973301,66.055822004981
2020-09-14T00:00:00Z,366.58,394.55,355,370.69,1027176.6755199999,1128513.119033,1027176.6755199999,1128513.119033,61.71507634897525,34971701.92594998,23946100.757496323,23946100.757496323,34971701.92594998,35.23200222392235,85.71428571428571,14.285714285714286,6.912601311456875,51.75401095085573,44.841409639398854,61.71507634897525,56.806311406552474,54.1242071173771
2020-09-21T00:00:00Z,371.03,376.76,313,357.55,1034788.72768,1104051.739192,1034788.72768,1104051.739192,59.42749320353828,33936913.198269986,24357354.62135158,24357354.62135158,33936913.198269986,33.85757404932064,78.57142857142857,7.142857142857143,3.2603974295527394,48.91690642633978,45.65650899678704,59.42749320353828,52.0070126739472,54.70616165674426
2020-09-28T00:00:00Z,357.53,370.25,334.19,352.48,655808.6440999999,1084579.1789949997,655808.6440999999,1084579.1789949997,58.52606279587358,33281104.554169986,24366811.651161123,24366811.651161123,33281104.554169986,32.5813193157619,71.42857142857143,0,0.0605541374946128,45.73220166865531,45.671647531160694,58.52606279587358,49.072657387020946,52.62866048917357
2020-10-05T00:00:00Z,352.42,380.81,332.87,374.38,627476.3693400001,1073519.8150429998,627476.3693400001,1073519.8150429998,61.25962788687137,33908580.923509985,24825966.24099106,24825966.24099106,33908580.923509985,31.628542857456114,64.28571428571429,0,-0.9669928496347708,44.46290646911723,45.429899318752,61.25962788687137,56.24928399587581,52.44298468561468
2020-10-12T00:00:00Z,374.37,395.18,361.38,378.58,535764.39711,1058433.1714449998,535764.39711,1058433.1714449998,61.77990624480845,34444345.320619985,24835476.851590645,24835476.851590645,34444345.320619985,31.05352440836341,57.142857142857146,0,-1.7064895634671728,43.29678736441804,45.00327692788521,61.77990624480845,57.41569565552898,54.24587901280861
2020-10-19T00:00:00Z,378.56,421.47,364.04,406.46,832958.68838,1046857.0304064999,832958.68838,1046857.0304064999,65.12785496669531,35277304.00899999,25233028.612839047,25233028.612839047,35277304.00899999,31.041767741491622,50,0,-0.7115845926540132,44.11379618706769,44.825380779721705,65.12785496669531,67.66366130929048,60.44288032023178
2020-10-26T00:00:00Z,406.32,411.77,373.4,396.91,705107.44602,1038378.8140989998,705107.44602,1038378.8140989998,63.089228984482716,34572196.56297999,25391985.595066648,25391985.595066648,34572196.56297999,31.03085083653924,42.857142857142854,0,-1.068818120891521,43.48935812860731,44.55817624949883,63.089228984482716,49.611299682470175,58.2302188824299
2020-11-02T00:00:00Z,396.91,468.98,370.5,454.61,1463578.92189,1079789.668164,1463578.92189,1079789.668164,69.33481858995013,36035775.48486999,26428439.63662441,26428439.63662441,36035775.48486999,31.980749363171313,35.714285714285715,0,2.0393548512274364,47.107369813533126,45.06801496230569,69.33481858995013,80.81028220173235,66.02841439783103
2020-11-09T00:00:00Z,454.61,478.31,433.83,448.58,1018671.36211,1091563.453062,1018671.36211,1091563.453062,68.03911645574428,35017104.12275999,26085370.90900733,26085370.90900733,35017104.12275999,32.99413100597525,28.571428571428573,28.571428571428573,3.0848941011539566,48.92413258874814,45.83923848759418,68.03911645574428,77.44062587314892,69.28740258578385
2020-11-16T00:00:00Z,448.6,581.8,445.91,560.82,1725248.7292399998,1153651.2236290001,1725248.7292399998,1153651.2236290001,76.74897239068885,36742352.85199999,27277898.785506804,27277898.785506804,36742352.85199999,35.02296124915723,100,21.428571428571427,10.323489600761647,58.743600488546235,48.42011088778459,76.74897239068885,92.28108903605595,83.51066570364577
2020-11-23T00:00:00Z,560.78,623.22,480.08,576.76,2207523.3329600003,1232036.0136,2207523.3329600003,1232036.0136,77.6792782801978,38949876.18495999,28052398.02947251,28052398.02947251,38949876.18495999,37.20655777421953,100,14.285714285714286,14.895143294262411,67.0390400056126,52.143896711350195,77.6792782801978,85.16697528893428,84.96289673271308
2020-11-30T00:00:00Z,576.9,636.53,561.15,601.95,1384277.53105,1269868.034889,1384277.53105,1269868.034889,79.1022850104722,40334153.71600999,28166622.044372104,28166622.044372104,40334153.71600999,39.32326913564956,100,7.142857142857143,18.11192023579919,74.78379700609918,56.67187677029999,79.1022850104722,89.40985514347841,88.9526398228229
2020-12-07T00:00:00Z,601.97,603.4,530.32,590.75,997025.1483699998,1253046.146689,997025.1483699998,1253046.146689,76.75911804585064,39337128.56763999,28818481.124682978,28818481.124682978,39337128.56763999,40.300566711775005,92.85714285714286,0,17.94725239857536,79.10594226851919,61.15868986994383,76.75911804585064,85.84984390937471,86.80889144726251
2020-12-14T00:00:00Z,590.45,677.05,575.58,638.4,1419583.0847599998,1221830.2308385002,1419583.0847599998,1221830.2308385002,79.53643287374034,40756711.652399994,29156623.660985816,29156623.660985816,40756711.652399994,41.79826197126303,100,14.285714285714286,19.386556740721062,85.39188579584516,66.0053290551241,79.53643287374034,89.38332646614477,88.214341839666
2020-12-21T00:00:00Z,638.19,714.99,551.45,684.12,1807660.5254900001,1243961.3158930002,1807660.5254900001,1243961.3158930002,81.78557073155507,42564372.177889995,30281851.99347256,30281851.99347256,42564372.177889995,43.43485129928228,100,7.142857142857143,21.588395083360325,92.99082290932449,71.40242782596417,81.78557073155507,92.3207044951367,89.18462495688543
2020-12-28T00:00:00Z,684.11,1015.14,680.9,980.44,2574790.09231,1288884.8169505002,2574790.09231,1288884.8169505002,89.69270246991363,45139162.2702,32322024.947180618,32322024.947180618,45139162.2702,46.04071404180615,100,0,40.096253193912275,121.52274431835451,81.42649112444224,89.69270246991363,94.91403696483798,92.20602264203985
2021-01-04T00:00:00Z,980.44,1350.88,886.33,1255.13,5330532.24138,1496723.2008840002,5330532.24138,1496723.2008840002,92.8091018646206,50469694.51158,35455168.48072665,35455168.48072665,50469694.51158,48.95062141366237,100,7.142857142857143,66.38243254991012,164.40453181182988,98.02209926191976,92.8091018646206,90.59439494700446,92.60971213565976
2021-01-11T00:00:00Z,1255.1,1294,905,1232.99,4452067.62419,1670301.3471895002,4452067.62419,1670301.3471895002,90.4357193058944,46017626.887389995,38510728.92881469,38510728.92881469,46017626.887389995,51.652678258957444,92.85714285714286,0,77.0716518711723,194.36166410088515,117.29001222971284,90.4357193058944,88.08590197069226,91.19811129417828
2021-01-18T00:00:00Z,1232.6,1440,1039.62,1394,3846179.88535,1743064.9618795,3846179.88535,1743064.9618795,92.03162387772747,49863806.77273999,41473127.03322608,41473127.03322608,49863806.77273999,54.30054778823193,100,0,88.93719550967097,228.46150661680156,139.5243111071306,92.03162387772747,95.72474813190081,91.46834834986589
2021-01-25T00:00:00Z,1394.04,1477.3,1206.05,1313.94,3150331.76085,1839827.5594049997,3150331.76085,1839827.5594049997,84.4829431108174,46713475.011889994,40828891.4469612,40828891.4469612,46713475.011889994,56.790595885134685,100,0,85.33079496137731,246.1878048088522,160.8570098474749,84.4829431108174,85.24033249006145,89.68366086421821
2021-02-01T00:00:00Z,1313.95,1763.93,1271.31,1615.32,3065154.46013,1941726.4486354995,3065154.46013,1941726.4486354995,88.35510213105289,49778629.47201999,42044699.13140236,42044699.13140236,49778629.47201999,59.29121815273468,100,7.142857142857143,96.36405655845459,281.31208054554315,184.94802398708856,88.35510213105289,89.33495044602168,90.10001035599468
2021-02-08T00:00:00Z,1615.51,1877.88,1565.98,1803.75,2151444.0697500003,1997559.215739,2151444.0697500003,1997559.215739,90.03023432724817,51930073.54177,43173465.74754179,43173465.74754179,51930073.54177,61.66850340125439,100,0,108.56695466079867,320.6567173130869,212.08976265228824,90.03023432724817,94.86652124233925,89.81393472614083
2021-02-15T00:00:00Z,1803.25,2041.42,1659.93,1935.57,1860252.85799,2057781.4264334994,1860252.85799,2057781.4264334994,91.00506133082489,53790326.39975999,44001409.685149916,44001409.685149916,53790326.39975999,63.94350887483515,100,0,117.0030981829346,358.34363538095647,241.34053719802188,91.00506133082489,93.36575765742616,92.52240978192907
2021-02-22T00:00:00Z,1935.67,1938.95,1292.76,1422.02,3527212.1700599995,2202768.2164694993,3527212.1700599995,2202768.2164694993,64.53201430196069,50263114.22969999,41885322.5560282,41885322.5560282,50263114.22969999,62.802963560417965,92.85714285714286,0,81.18339689880406,342.819783321527,261.6363864227229,64.53201430196069,60.32894821115195,82.85374237030584
2021-03-01T00:00:00Z,1421.8,1735,1412.61,1728.22,1803971.97671,2266178.5954494993,1803971.97671,2266178.5954494993,70.1142663556274,52067086.20640999,43613417.92364925,43613417.92364925,52067086.20640999,61.74388576845915,85.71428571428571,0,71.63221393014481,351.17665383540395,279.54443990525914,70.1142663556274,79.27337701012509,77.65602762623445
2021-03-08T00:00:00Z,1727.95,1944,1664.08,1848.9,1663871.2956,2307724.225810499,1663871.2956,2307724.225810499,71.98567196028235,53730957.50200999,44146722.19858935,44146722.19858935,53730957.50200999,61.26014945284022,78.57142857142857,7.142857142857143,67.04360083294671,363.34894094644255,296.30534011349584,71.98567196028235,87.25961220303091,75.62064580810271
2021-03-15T00:00:00Z,1848.56,1893.75,1706.25,1784,1227760.90809,2333856.898913999,1227760.90809,2333856.898913999,69.46641218774516,52503196.593919985,43937184.33694199,43937184.33694199,52503196.593919985,60.81096573119407,71.42857142857143,0,53.8098850919979,363.5676964784932,309.7578113864953,69.46641218774516,82.7231420766861,83.0853770966141
2021-03-22T00:00:00Z,1784.11,1806.39,1545.77,1686.92,1358810.00352,2328618.452995499,1358810.00352,2328618.452995499,65.75915377816389,51144386.59039999,44050218.643120766,44050218.643120766,51144386.59039999,59.210078269734076,64.28571428571429,7.142857142857143,33.67502370983755,351.85159102379225,318.1765673139547,65.75915377816389,76.20757464915401,82.0634429762904
2021-03-29T00:00:00Z,1686.92,2145,1675.28,2076.36,1413137.96329,2348341.7830544994,1413137.96329,2348341.7830544994,72.17445606533506,52557524.55368999,45050354.009969376,45050354.009969376,52557524.55368999,58.58374889971475,100,0,41.24197825188628,369.7290401288126,328.4870618769263,72.17445606533506,95.31179564237416,84.74750412273815
2021-04-05T00:00:00Z,2076.31,2195,1929.69,2150.54,1151328.3166099999,2319645.7624229994,1151328.3166099999,2319645.7624229994,73.20429379554035,53708852.87029999,45815808.76767484,45815808.76767484,53708852.87029999,58.10888832287154,100,0,45.562066574991036,385.4396450956651,339.8775785206741,73.20429379554035,96.60265766006708,89.37400931719849
2021-04-12T00:00:00Z,2150.54,2548,2000,2241.46,1873234.1495,2302931.303249999,1873234.1495,2302931.303249999,74.45234789547007,55582087.019799985,45593345.12086926,45593345.12086926,55582087.019799985,58.30819334982714,100,0,48.58507841213367,400.6089265358412,352.0238481237075,74.45234789547007,81.34266585514303,91.08570638586149
2021-04-19T00:00:00Z,2241.67,2646.2,2040,2322.16,2589235.67033,2363179.2102139993,2589235.67033,2363179.2102139993,75.54127980347958,58171322.69012999,45414464.90002891,45414464.90002891,58171322.69012999,58.64104455298917,100,0,49.873684814960654,414.3659541424083,364.4922693274477,75.54127980347958,79.83044728553823,85.92525693358283
2021-04-26T00:00:00Z,2322.43,2986,2306.03,2952.09,1847671.0857199999,2405711.5070815,1847671.0857199999,2405711.5070815,81.99320792562807,60018993.77584999,47077849.836310655,47077849.836310655,60018993.77584999,59.385782496193706,100,0,84.94455189809128,470.67295920006177,385.7284073019705,81.99320792562807,98.09489030590748,86.42266781552964
2021-05-03T00:00:00Z,2952.21,3984,2952.08,3928.44,3039149.6324399994,2486689.8344654995,3039149.6324399994,2486689.8344654995,87.49793213907233,63058143.40828999,49789735.42971979,49789735.42971979,63058143.40828999,60.8341023094732,100,0,161.2651219835543,587.3098097814134,426.04468779785907,87.49793213907233,97.95184853411189,91.95906204185259
2021-05-10T00:00:00Z,3928.41,4384.43,3334.88,3585.62,3566894.2546300003,2574651.5209224997,3566894.2546300003,2574651.5209224997,78.43152573077492,59491249.15365999,47927120.27643022,47927120.27643022,59491249.15365999,62.36625146630887,100,0,174.88545296176324,644.6515040000631,469.7660510382999,78.43152573077492,74.16250764150118,90.06974882717357
2021-05-17T00:00:00Z,3584.79,3590,1728,2099.58,6486214.67928,2770222.750270999,6486214.67928,2770222.750270999,52.861708600668386,53005034.474379994,44029678.58375265,44029678.58375265,53005034.474379994,59.130367263977924,92.85714285714286,14.285714285714286,75.13625956400529,563.6863754933065,488.5501159293012,52.861708600668386,26.096575637115215,66.07031060424282
2021-05-24T00:00:00Z,2100.07,2913.68,2072.15,2387.66,4043519.71716,2705872.1240599994,4043519.71716,2705872.1240599994,55.86558219227535,57048554.191539995,43018186.02180078,43018186.02180078,57048554.191539995,56.12561764752776,85.71428571428571,7.142857142857143,22.607205163839524,516.8091223841006,494.2019172202611,55.86558219227535,35.41451707329695,45.22453345063784
2021-05-31T00:00:00Z,2387.65,2890,2275.22,2710.97,1910095.0450700002,2578773.495103999,1910095.0450700002,2578773.495103999,59.02169501040412,58958649.236609995,43815804.031447105,43815804.031447105,58958649.236609995,53.33549300368118,78.57142857142857,0,4.6252488158168035,499.9834782400321,495.3582294242153,59.02169501040412,43.68905249981491,35.06671507007576
2021-06-07T00:00:00Z,2710.97,2849.15,2257.07,2510.23,1732649.20482,2473096.961077499,1732649.20482,2473096.961077499,56.32829304110773,57226000.031789996,43564837.95286758,43564837.95286758,57226000.031789996,50.70266877061318,71.42857142857143,0,-24.214800497384203,465.08972880248507,489.3045292998693,56.32829304110773,33.975890032621024,37.693153201911024
2021-06-14T00:00:00Z,2510.22,2640,2042.5,2242.9,1338071.41066,2382483.943567999,1338071.41066,2382483.943567999,52.86823959524619,55887928.62113,43124338.12612813,43124338.12612813,55887928.62113,47.75791176281605,64.28571428571429,14.285714285714286,-62.54307688915577,411.12568318842455,473.6687600775803,52.86823959524619,24.558418408685792,34.07445364704064
2021-06-21T00:00:00Z,2242.89,2259.1,1700,1984.71,2501018.16445,2354277.128783999,2501018.16445,2354277.128783999,49.69333442610377,53386910.45668,43170502.51077689,43170502.51077689,53386910.45668,44.40196298013531,57.142857142857146,7.142857142857143,-104.08331684265318,343.56461402426385,447.647930866917,49.69333442610377,15.462929692178704,24.665746044495236
2021-06-28T00:00:00Z,1984.84,2389.22,1957.24,2323.15,1406678.21097,2317038.8358449987,1406678.21097,2317038.8358449987,53.62475142463467,54793588.66765,44146886.590542726,44146886.590542726,54793588.66765,41.44064576074972,50,0,-107.14638561370356,313.71494884978756,420.8613344634911,53.62475142463467,23.91414281232121,21.311830304395297
2021-07-05T00:00:00Z,2323.27,2411.19,2050,2140.82,1102148.33521,2279133.609705999,1102148.33521,2279133.609705999,51.29884471087513,53691440.33244,43599001.17403907,43599001.17403907,53691440.33244,38.737050892375905,42.857142857142854,0,-118.92225428784093,272.20851660369,391.1307708915309,51.29884471087513,16.421363194421165,18.599478566307088
2021-07-12T00:00:00Z,2141.45,2169,1847,1891.46,1239907.6198100003,2164768.3821934992,1239907.6198100003,2164768.3821934992,48.218535218632944,52451532.712629996,42701492.88824617,42701492.88824617,52451532.712629996,36.17381805616827,35.714285714285715,78.57142857142857,-139.54847678432736,216.69517491112174,356.2436516954491,48.218535218632944,7.1322403638761305,15.822582123539563
2021-07-19T00:00:00Z,1891.46,2200,1718.41,2193.03,1388049.07935,2143972.2373254993,1388049.07935,2143972.2373254993,51.97436511426363,53839581.79198,44049363.79909986,44049363.79909986,53839581.79198,34.07607502217383,28.571428571428573,71.42857142857143,-129.1635441969226,194.78922144929584,323.95276564621844,51.97436511426363,18.36628260003055,13.973295386109344
2021-07-26T00:00:00Z,2192.38,2699,2152,2555.43,1677736.9900099998,2144665.5220459993,1677736.9900099998,2144665.5220459993,56.095573960913256,55517318.78199,44846396.21998469,44846396.21998469,55517318.78199,32.26486360884454,21.428571428571427,64.28571428571429,-95.70939738101237,204.31601891995297,300.02541630096533,56.095573960913256,31.866355241149883,19.121626068352253
2021-08-02T00:00:00Z,2555.99,3191.99,2445.58,3014.13,1875773.5146899999,2177066.152375999,1875773.5146899999,2177066.152375999,60.69330225031654,57393092.296679996,45828223.840801984,45828223.840801984,57393092.296679996,31.45629583128433,14.285714285714286,57.142857142857146,-43.18585356577637,246.04309934374487,289.22895290952124,60.69330225031654,48.953781622169316,33.06213982111665
2021-08-09T00:00:00Z,3014.12,3333,2892.5,3310.93,1449298.69673,2181590.5870364993,1449298.69673,2181590.5870364993,63.366512419051844,58842390.99341,47132296.55688803,47132296.55688803,58842390.99341,30.929219942839982,7.142857142857143,50,8.302997418986536,299.6076996832544,291.30470226426786,63.366512419051844,60.01013250485204,46.94342312272381
2021-08-16T00:00:00Z,3311.02,3341.47,2951,3241.42,1159499.91559,2168908.6846514996,1159499.91559,2168908.6846514996,62.29792948643079,57682891.077819996,47697599.90652019,47697599.90652019,57682891.077819996,30.45365627025222,0,42.857142857142854,33.04821968933635,332.6149768759383,299.56675718660193,62.29792948643079,81.55661375661376,63.506842627878434
2021-08-23T00:00:00Z,3241.41,3378.6,3050,3226.46,942974.3184400001,2158490.9847429995,942974.3184400001,2158490.9847429995,62.055381948900774,56739916.75938,47767390.33690503,47767390.33690503,56739916.75938,30.076566085798774,0,35.714285714285715,43.13979813433912,353.49150485452583,310.3517067201867,62.055381948900774,90.93649469796259,77.50108031980953
2021-08-30T00:00:00Z,3226.45,4030.35,3145.45,3952.17,1568728.56054,2143265.7052949993,1568728.56054,2143265.7052949993,68.46868224131875,58308645.319919996,49058927.804975785,49058927.804975785,58308645.319919996,30.709596418910884,100,28.571428571428573,90.6872440338384,423.7107617624847,333.0235177286463,68.46868224131875,96.64513914218894,89.71274919892183
2021-09-06T00:00:00Z,3951.68,3973.27,3009,3403.75,1728603.96402,2100234.1199794994,1728603.96402,2100234.1199794994,60.189507651290405,56580041.3559,48745625.395078376,48745625.395078376,56580041.3559,30.902191554351838,92.85714285714286,21.428571428571427,77.70009175730155,430.14863242527326,352.4485406679717,60.189507651290405,73.11133520715772,86.89765634910316
2021-09-13T00:00:00Z,3403.81,3675.92,3111.14,3328.59,1107277.78491,2063214.4549389991,1107277.78491,2063214.4549389991,59.134169248713285,55472763.570989996,48490989.539162606,48490989.539162606,55472763.570989996,31.08102989440415,85.71428571428571,14.285714285714286,57.47708742878291,424.29489995395033,366.8178125251674,59.134169248713285,69.88606861630228,79.88084765521639
2021-09-20T00:00:00Z,3328.7,3346.58,2651,3060.71,1993120.63387,2010913.0050104992,1993120.63387,2010913.0050104992,55.405434272132695,53479642.93712,48845841.69031483,48845841.69031483,53479642.93712,29.962959471697726,78.57142857142857,7.142857142857143,21.34897244005299,393.5040280752337,372.1550556351807,55.405434272132695,58.39079966528633,67.12940116291551
2021-09-27T00:00:00Z,3059.92,3489.18,2781.99,3420.07,1176741.30521,1891405.3575394992,1176741.30521,1891405.3575394992,59.128633709257045,54656384.24233,49792589.38248431,49792589.38248431,54656384.24233,29.18474911762296,71.42857142857143,0,17.1260705356367,393.5626438047266,376.4365732690899,59.128633709257045,73.60312118826614,67.29332982328498
2021-10-04T00:00:00Z,3419.63,3670,3269.67,3415,1060117.54689056,1620100.5009200273,1060117.54689056,1620100.5009200273,59.05372288923352,53596266.69543944,49502171.249025695,49502171.249025695,53596266.69543944,28.783026997146123,64.28571428571429,21.428571428571427,9.82600457755035,388.7190789910278,378.89307441347745,59.05372288923352,73.38382483974499,68.45924856443254
2021-10-11T00:00:00Z,3414.75,3968.49,3373.45,3847.18,1153259.58484203,1475587.4943041287,1153259.58484203,1475587.4943041287,63.319721599469986,54749526.28028147,50185203.89034397,50185203.89034397,54749526.28028147,28.90041468120777,57.142857142857146,14.285714285714286,28.86179137775241,414.97031363566794,386.1085222579155,63.319721599469986,92.07721653676133,79.68805418825755
2021-10-18T00:00:00Z,3847.38,4374.95,3676.35,4082.64,1269799.9213366401,1443572.7381174606,1269799.9213366401,1443572.7381174606,65.43276353870722,56019326.20161811,50392377.945645936,50392377.945645936,56019326.20161811,29.587813608859072,100,7.142857142857143,50.7865003904829,449.59164774601913,398.80514735553623,65.43276353870722,88.99658954881158,84.81921030843937
2021-10-25T00:00:00Z,4082.09,4461.96,3899.41,4312.43,1192681.5298658002,1416574.3543697507,1192681.5298658002,1416574.3543697507,67.40427753583043,57212007.679338664,50951012.12270458,50951012.12270458,57212007.679338664,30.340854940883315,100,0,72.89500154170298,489.92389928266493,417.02889774096195,67.40427753583043,93.51677085317493,91.53019231291601